,title,foreign_gross,release_date,production_budget,domestic_gross_y,worldwide_gross,net_profit,ROI
0,Toy Story 3,652000000,2010-06-18,200000000,415004880,1068879522,868879522,434.439761
1,Inception,535700000,2010-07-16,160000000,292576195,835524642,675524642,422.20290125
2,Shrek Forever After,513900000,2010-05-21,165000000,238736787,756244673,591244673,358.3301048484849
3,The Twilight Saga: Eclipse,398000000,2010-06-30,68000000,300531751,706102828,638102828,938.3865117647058
4,Iron Man 2,311500000,2010-05-07,170000000,312433331,621156389,451156389,265.3861111764706
5,Tangled,391000000,2010-11-24,260000000,200821936,586477240,326477240,125.56816923076923
6,Despicable Me,291600000,2010-07-09,69000000,251513985,543464573,474464573,687.6298159420289
7,How to Train Your Dragon,277300000,2010-03-26,165000000,217581232,494870992,329870992,199.92181333333335
8,The Chronicles of Narnia: The Voyage of the Dawn Treader,311300000,2010-12-10,155000000,104386950,418186950,263186950,169.79803225806452
9,The Karate Kid,182500000,2010-06-11,40000000,176591618,351774938,311774938,779.437345
11,Black Swan,222400000,2010-12-03,13000000,106954678,331266710,318266710,2448.205461538462
12,Megamind,173500000,2010-11-05,130000000,148415853,321887208,191887208,147.60554461538462
13,Robin Hood,216400000,2010-05-14,210000000,105487148,322459006,112459006,53.551907619047626
15,The Last Airbender,187900000,2010-07-01,150000000,131772187,319713881,169713881,113.14258733333334
16,Little Fockers,162200000,2010-12-22,100000000,148438600,310650574,210650574,210.65057399999998
17,Resident Evil: Afterlife,240100000,2010-09-10,57500000,60128566,295874190,238374190,414.5638086956522
18,Shutter Island,166800000,2010-02-19,80000000,128012934,299461782,219461782,274.3272275
19,Salt,175200000,2010-07-23,130000000,118311368,290650494,160650494,123.57730307692307
20,Sex and the City 2,193000000,2010-05-27,95000000,95347692,294680778,199680778,210.19029263157893
21,The Tourist,210700000,2010-12-10,100000000,67631157,278731369,178731369,178.731369
22,The Expendables,171400000,2010-08-13,82000000,103068524,268268174,186268174,227.15630975609758
23,Grown Ups,109400000,2010-06-25,75000000,162001186,272223430,197223430,262.9645733333333
24,True Grit,81000000,2010-12-22,35000000,171243005,252276928,217276928,620.7912228571429
25,Gulliver's Travels,194600000,2010-12-25,112000000,42779261,232017848,120017848,107.15879285714284
26,The Social Network,128000000,2010-10-01,40000000,96962694,224922135,184922135,462.30533749999995
27,Valentine's Day,106000000,2010-02-12,52000000,110485654,217569328,165569328,318.40255384615386
28,The Sorcerer's Apprentice,152100000,2010-07-14,160000000,63150991,217986320,57986320,36.24145
29,Due Date,111200000,2010-11-05,65000000,100539043,211739043,146739043,225.75237384615386
30,Eat Pray Love,124000000,2010-08-13,60000000,80574010,206598789,146598789,244.331315
31,Yogi Bear,101300000,2010-12-17,80000000,100246011,204774690,124774690,155.96836249999998
32,Red,108600000,2010-10-15,60000000,90380162,196439693,136439693,227.39948833333332
33,Paranormal Activity 2,92800000,2010-10-20,3000000,84752907,177512032,174512032,5817.067733333333
34,The A-Team,100000000,2010-06-11,110000000,77222099,177241171,67241171,61.12833727272727
35,The Other Guys,51200000,2010-08-06,100000000,119219978,170936470,70936470,70.93647
36,Unstoppable,86200000,2010-11-12,95000000,81562942,165720921,70720921,74.4430747368421
37,The Book of Eli,62300000,2010-01-15,80000000,94835059,158750817,78750817,98.43852125
38,The Town,61800000,2010-09-17,37000000,92186262,152566881,115566881,312.3429216216216
39,Date Night,53600000,2010-04-09,55000000,98711404,152269033,97269033,176.85278727272726
40,Legend of the Guardians: The Owls of Ga'Hoole,84400000,2010-09-24,100000000,55675313,139716717,39716717,39.716717
41,The Wolfman,77800000,2010-02-12,150000000,62189884,142634358,-7365642,-4.910428
42,The Bounty Hunter,69300000,2010-03-19,45000000,67061228,135808837,90808837,201.79741555555557
43,Saw 3D,90400000,2010-10-29,17000000,45710178,133735284,116735284,686.6781411764705
44,The Fighter,35600000,2010-12-10,11000000,93617009,129262388,118262388,1075.112618181818
45,Predators,75200000,2010-07-09,40000000,52000688,127234389,87234389,218.0859725
46,Dear John,35000000,2010-02-05,25000000,80014842,142033509,117033509,468.13403600000004
47,Cats & Dogs: The Revenge of Kitty Galore,68900000,2010-07-30,85000000,43585753,113026383,28026383,32.972215294117646
48,Tooth Fairy,52400000,2010-01-22,48000000,60022256,112610386,64610386,134.60497083333334
49,Life as We Know It,52300000,2010-10-08,38000000,53374681,105887837,67887837,178.65220263157894
50,Hereafter,72500000,2010-10-15,50000000,32746941,108660270,58660270,117.32054000000001
51,The Girl with the Dragon Tattoo,94300000,2011-12-20,90000000,102515793,239373970,149373970,165.97107777777777
52,Love and Other Drugs,70500000,2010-11-24,30000000,32367005,102716321,72716321,242.38773666666668
53,Killers,51100000,2010-06-04,75000000,47059963,95572749,20572749,27.430332
54,Kick-Ass,48100000,2010-04-16,28000000,48071303,97531134,69531134,248.32547857142856
55,Green Zone,59800000,2010-03-12,100000000,35497337,97523020,-2476980,-2.47698
56,Get Him to the Greek,30300000,2010-06-04,40000000,61153526,91455875,51455875,128.6396875
57,Burlesque,50100000,2010-11-24,55000000,39440655,90552675,35552675,64.64122727272728
58,The Last Song,26100000,2010-03-31,20000000,62950384,92678948,72678948,363.39473999999996
59,Dinner for Schmucks,13800000,2010-07-30,69000000,73026337,86796502,17796502,25.79203188405797
60,Marmaduke,50100000,2010-06-04,50000000,33644788,89895930,39895930,79.79186
61,Piranha 3D,58200000,2010-08-20,24000000,25003155,83660160,59660160,248.584
62,Oceans,63200000,2010-04-22,80000000,19422319,86787530,6787530,8.484412500000001
63,Edge of Darkness,37800000,2010-01-29,60000000,43313890,82812456,22812456,38.020759999999996
64,Vampires Suck,43900000,2010-08-18,20000000,36661504,81424988,61424988,307.12494000000004
65,Letters to Juliet,26100000,2010-05-14,30000000,53032453,82148538,52148538,173.82846
66,Diary of a Wimpy Kid,11700000,2010-03-19,15000000,64003625,76954311,61954311,413.02874
67,Easy A,16600000,2010-09-17,8000000,58401464,76200721,68200721,852.5090125
68,Takers,11300000,2010-08-27,32000000,57744720,70587268,38587268,120.58521250000001
69,The American,32299999,2010-09-01,20000000,35606376,67950723,47950723,239.753615
70,The Last Exorcism,26700000,2010-08-27,1800000,41034350,70165900,68365900,3798.105555555556
71,The Next Three Days,46300000,2010-11-19,30000000,21148651,67255916,37255916,124.18638666666666
72,Skyline,45400000,2010-11-12,10000000,21416355,68264973,58264973,582.64973
73,Hot Tub Time Machine,14300000,2010-03-26,36000000,50269859,65967750,29967750,83.24375
74,Devil,29100000,2010-09-17,10000000,33679655,63354114,53354114,533.54114
75,127 Hours,42400000,2010-11-05,18000000,18335230,60217171,42217171,234.5398388888889
76,Secretariat,537000,2010-10-08,35000000,59699513,60376247,25376247,72.50356285714285
77,The Ghost Writer,44700000,2010-02-19,45000000,15541549,65532491,20532491,45.62775777777778
78,Morning Glory,29000000,2010-11-10,40000000,31011732,59795070,19795070,49.487674999999996
79,Remember Me,37000000,2010-03-12,16000000,19068240,56506120,40506120,253.16325
80,Cop Out,10700000,2010-02-26,37000000,44875481,55909910,18909910,51.10786486486486
81,The Crazies,15700000,2010-02-26,19000000,39123589,56445534,37445534,197.08175789473685
82,Daybreakers,21300000,2010-01-08,20000000,30101577,51445503,31445503,157.227515
83,The Switch,22100000,2010-08-20,19000000,27758465,49858465,30858465,162.41297368421053
84,She's Out of My League,17800000,2010-03-12,20000000,32010860,48680977,28680977,143.40488499999998
85,Charlie St. Cloud,17000000,2010-07-30,44000000,31206263,48478084,4478084,10.177463636363635
86,The Spy Next Door,20900000,2010-01-15,28000000,24307106,46752858,18752858,66.97449285714285
87,Machete,17500000,2010-09-03,12500000,26593646,46370970,33870970,270.96776
88,My Name is Khan,38300000,2010-02-12,8470000,4046336,42355526,33885526,400.0652420306966
89,Going the Distance,24200000,2010-09-03,32000000,17804299,43603990,11603990,36.26246875
90,Agora,38400000,2010-05-28,70000000,619423,38992292,-31007708,-44.296725714285714
91,For Colored Girls,17300,2010-11-05,21000000,37729698,38017873,17017873,81.03749047619047
92,Brooklyn's Finest,9300000,2010-03-05,17000000,27163593,39233233,22233233,130.78372352941176
93,Furry Vengeance,18600000,2010-04-30,35000000,17630465,39340177,4340177,12.400505714285714
94,Faster,12400000,2010-11-24,24000000,23240020,35792945,11792945,49.13727083333333
95,The Kids Are All Right,13900000,2010-07-09,4000000,20811365,36275469,32275469,806.8867250000001
96,You Will Meet a Tall Dark Stranger,31000000,2010-09-22,15000000,3247816,34247816,19247816,128.31877333333333
97,Leap Year,6700000,2010-01-08,19000000,25918920,32618920,13618920,71.67852631578947
98,You Again,6300000,2010-09-24,20000000,25702053,32838945,12838945,64.19472499999999
99,The Losers,5800000,2010-04-23,25000000,23591432,29863840,4863840,19.45536
100,Case 39,14900000,2010-10-01,27000000,13261851,28773827,1773827,6.56972962962963
101,Ramona and Beezus,1100000,2010-07-23,15000000,26167002,27469621,12469621,83.13080666666667
102,Splice,9800000,2010-06-04,30000000,17010170,28542494,-1457506,-4.8583533333333335
103,Let Me In,12000000,2010-10-01,20000000,12134935,28270399,8270399,41.351995
104,Mao's Last Dancer,17500000,2010-08-20,18000000,4806750,25941437,7941437,44.11909444444444
105,Just Wright,29900,2010-05-14,12000000,21540363,21867665,9867665,82.23054166666667
106,Our Family Wedding,1200000,2010-03-12,14000000,20255281,21410546,7410546,52.932471428571425
107,My Soul to Take,6200000,2010-10-08,25000000,14744435,16727470,-8272530,-33.09012
108,"I Love You, Phillip Morris",18700000,2010-12-03,13000000,2037459,23014027,10014027,77.03097692307692
109,Country Strong,310000,2010-12-22,15000000,20218921,20601987,5601987,37.34658
110,Another Year,16500000,2010-12-29,8000000,3205706,20005613,12005613,150.0701625
111,Youth in Revolt,4400000,2010-01-08,18000000,15285588,19685588,1685588,9.36437777777778
112,Buried,18100000,2010-09-24,1987650,1044143,21270290,19282640,970.1225064774986
113,[Rec] 2,18500000,2010-07-09,5600000,27766,18527766,12927766,230.85296428571428
114,Repo Men,4600000,2010-03-19,32000000,13942007,18195238,-13804762,-43.13988125
115,Soul Kitchen,17600000,2010-08-20,4900000,276901,23347461,18447461,376.4787959183673
116,Micmacs,15100000,2010-05-28,42000000,1259693,11756922,-30243078,-72.00732857142857
117,The Nutcracker in 3D,16000000,2010-11-24,90000000,195459,20466016,-69533984,-77.25998222222222
118,Sea Rex 3D: Journey to a Prehistoric World,9900000,2010-05-28,5000000,6096582,16515203,11515203,230.30406000000002
119,Extraordinary Measures,3100000,2010-01-22,31000000,12482741,15826984,-15173016,-48.9452129032258
120,Somewhere,12200000,2010-12-22,7000000,1785645,17023121,10023121,143.18744285714286
121,Winter's Bone,7300000,2010-06-11,2000000,6531503,16131551,14131551,706.57755
122,The Last Station,6900000,2010-01-15,18000000,6617867,15696146,-2303854,-12.799188888888887
123,Made in Dagenham,11300000,2010-11-19,8000000,1095369,15644196,7644196,95.55245
124,Blue Valentine,2600000,2010-12-29,1000000,9737892,16566240,15566240,1556.624
125,Chloe,8600000,2010-03-26,13000000,3075255,11831131,-1168869,-8.9913
126,The Warrior's Way,5400000,2010-12-03,42000000,5666340,8514325,-33485675,-79.72779761904762
127,Jonah Hex,356000,2010-06-18,47000000,10547117,11022696,-35977304,-76.54745531914894
128,Harry Brown,8500000,2010-04-30,7300000,1818681,12023606,4723606,64.70693150684932
129,Cyrus,2500000,2010-06-18,7000000,7468936,10062896,3062896,43.75565714285714
130,Conviction,2900000,2010-10-15,12500000,6797696,11826980,-673020,-5.3841600000000005
131,Get Low,518000,2010-07-30,7000000,9176933,10828305,3828305,54.69007142857143
132,Stone,7700000,2010-10-08,22000000,1810078,4065020,-17934980,-81.52263636363635
133,Never Let Me Go,7000000,2010-09-15,15000000,2434652,11173718,-3826282,-25.508546666666664
134,MacGruber,797000,2010-05-21,10000000,8525600,8629895,-1370105,-13.70105
135,City Island,1200000,2010-03-19,6000000,6671283,8173486,2173486,36.22476666666667
136,Inside Job,3600000,2010-10-08,2000000,4311834,7799257,5799257,289.96285
137,The Joneses,5500000,2010-04-16,10000000,1475746,3541565,-6458435,-64.58435
138,Centurion,6700000,2010-08-27,15000000,123570,7885048,-7114952,-47.433013333333335
139,Animal Kingdom,5700000,2010-08-13,4200000,1044039,8078683,3878683,92.34959523809523
140,Nowhere Boy,5100000,2010-10-08,1900000,1445366,7785229,5885229,309.7488947368421
141,It's Kind of a Funny Story,128000,2010-10-08,8000000,6363628,6632950,-1367050,-17.088125
142,Solitary Man,818000,2010-05-21,12500000,4360548,4360548,-8139452,-65.115616
143,Rabbit Hole,2900000,2010-12-17,5000000,2229058,6205034,1205034,24.10068
144,Mother and Child,3900000,2010-05-07,7000000,1110509,6537179,-462821,-6.611728571428571
145,The Runaways,1100000,2010-03-19,9500000,3573673,5278632,-4221368,-44.43545263157895
146,Four Lions,4400000,2010-11-05,3750000,310007,2436111,-1313889,-35.037040000000005
147,Please Give,280000,2010-04-30,3000000,4033574,4570178,1570178,52.33926666666666
148,Monsters,4000000,2010-10-29,500000,237301,5639730,5139730,1027.946
149,The Killer Inside Me,3800000,2010-06-18,13000000,217277,3617277,-9382723,-72.1747923076923
150,The Perfect Game,2800000,2010-04-16,12500000,1089445,3931367,-8568633,-68.549064
151,To Save a Life,45800,2010-01-22,500000,3777210,3824868,3324868,664.9736
152,Wild Target,3300000,2010-10-29,8000000,109338,5314194,-2685806,-33.572575
153,Kites,1300000,2010-05-21,9200000,1685269,17155193,7955193,86.46948913043478
154,Letters to God,60300,2010-04-09,3000000,2848587,3237452,237452,7.915066666666666
155,Fish Tank,2000000,2010-01-15,3000000,374675,5922292,2922292,97.40973333333334
156,Housefull,1200000,2010-04-30,10100000,1183658,18726300,8626300,85.4089108910891
157,After.Life,1900000,2010-04-09,4500000,108596,2481925,-2018075,-44.84611111111111
158,Flipped,0,2010-08-06,14000000,1755212,4289993,-9710007,-69.35719285714286
159,Ondine,1100000,2010-06-04,12000000,550472,557545,-11442455,-95.35379166666667
160,The City of Your Final Destination,859000,2010-04-16,8300000,493296,1353296,-6946704,-83.69522891566265
161,It's a Wonderful Afterlife,1300000,2010-10-08,10000000,0,1642939,-8357061,-83.57061
162,Ajami,669000,2010-02-03,1000000,621859,2721096,1721096,172.1096
163,Casino Jack,40700,2010-12-17,12500000,2039869,2272186,-10227814,-81.822512
164,Leaves of Grass,949000,2010-04-02,9000000,70066,85527,-8914473,-99.0497
165,Carlos,726000,2010-10-15,18000000,145526,1619153,-16380847,-91.00470555555556
166,The Disappearance of Alice Creed,701000,2010-08-06,1500000,166980,1605139,105139,7.009266666666666
167,Life During Wartime,487000,2010-07-23,4500000,281447,281447,-4218553,-93.74562222222222
168,Enter the Void,418000,2010-09-24,16000000,337997,1467278,-14532722,-90.82951249999999
169,The Secret of Kells,62700,2010-03-05,8000000,690290,3582797,-4417203,-55.215037499999994
170,All Good Things,62500,2010-12-03,20000000,582024,873617,-19126383,-95.631915
171,Chain Letter,447000,2010-10-01,3000000,205842,1022453,-1977547,-65.91823333333333
172,I Spit on Your Grave,480000,2010-10-08,1750000,93051,1278471,-471529,-26.944514285714288
173,The Extra Man,4500,2010-07-30,7000000,453377,492108,-6507892,-92.96988571428571
174,Tiny Furniture,0,2010-11-12,50000,391674,424149,374149,748.298
175,The Tempest,68700,2010-12-10,20000000,277943,277943,-19722057,-98.610285
176,The Good Heart,323000,2010-04-30,3800000,20930,340930,-3459070,-91.02815789473684
177,Welcome to the Rileys,158000,2010-10-29,10000000,152857,355919,-9644081,-96.44081
178,The Girl on the Train,97100,2016-10-07,45000000,75395035,174278214,129278214,287.28492
179,"Lovely, Still",106000,2010-09-10,5000000,127564,282687,-4717313,-94.34626
180,The Eclipse,26400,2010-03-26,3000000,133411,133411,-2866589,-95.55296666666668
181,George A. Romero's Survival of the Dead,41500,2010-05-28,4200000,101740,101740,-4098260,-97.57761904761905
182,Freakonomics,16400,2010-10-01,2900000,101270,172867,-2727133,-94.03906896551723
183,Saint John of Las Vegas,9100,2010-01-29,2000000,102645,102645,-1897355,-94.86775
184,Transformers: Dark of the Moon,771400000,2011-06-29,195000000,352390543,1123790543,928790543,476.3028425641026
185,Pirates of the Caribbean: On Stranger Tides,804600000,2011-05-20,410600000,241063875,1045663875,635063875,154.6672856794934
186,Kung Fu Panda 2,500400000,2011-05-26,150000000,165249063,664837547,514837547,343.22503133333333
187,Fast Five,416300000,2011-04-29,125000000,210031325,630163454,505163454,404.1307632
188,The Hangover Part II,332300000,2011-05-26,80000000,254464305,586464305,506464305,633.08038125
189,The Smurfs,421100000,2011-07-29,110000000,142614158,563749323,453749323,412.4993845454545
190,Cars 2,370700000,2011-06-24,200000000,191450875,560155383,360155383,180.0776915
191,Puss in Boots,405700000,2011-10-28,130000000,149260504,554987477,424987477,326.9134438461538
192,Sherlock Holmes: A Game of Shadows,358600000,2011-12-16,125000000,186848418,535663443,410663443,328.53075440000003
193,Rio,341000000,2011-04-15,90000000,143619809,487519809,397519809,441.6886766666667
194,Rise of the Planet of the Apes,305000000,2011-08-05,93000000,176760185,470986200,377986200,406.43677419354833
195,Thor,268300000,2011-05-06,150000000,181030624,449326618,299326618,199.55107866666665
196,The Adventures of Tintin,296400000,2011-12-21,130000000,77591831,373993951,243993951,187.68765461538462
197,Captain America: The First Avenger,193900000,2011-07-22,140000000,176654505,370569776,230569776,164.69269714285716
198,X-Men: First Class,207200000,2011-06-03,160000000,146408305,355408305,195408305,122.13019062499998
199,Alvin and the Chipmunks: Chipwrecked,209600000,2011-12-16,80000000,133107389,349088523,269088523,336.36065375
200,Real Steel,213800000,2011-10-07,110000000,85463309,263880341,153880341,139.8912190909091
201,Bridesmaids,119300000,2011-05-13,32500000,169211718,289632023,257132023,791.1754553846154
202,Super 8,133100000,2011-06-10,50000000,127004179,257972745,207972745,415.94549
203,Rango,122200000,2011-03-04,135000000,123477607,245724600,110724600,82.01822222222222
204,The Green Hornet,129000000,2011-01-14,110000000,98780042,229155503,119155503,108.32318454545455
205,Immortals,143400000,2011-11-11,75000000,83504017,211562435,136562435,182.08324666666667
206,Green Lantern,103300000,2011-06-17,200000000,116601172,219535492,19535492,9.767745999999999
207,The Help,46900000,2011-08-10,25000000,169705587,213120004,188120004,752.480016
208,Bad Teacher,115900000,2011-06-24,19000000,100292856,215448997,196448997,1033.942089473684
209,Just Go With It,111900000,2011-02-11,80000000,103028109,214974953,134974953,168.71869125
210,Battle: Los Angeles,128300000,2011-03-11,70000000,83552429,213463976,143463976,204.94853714285713
211,Horrible Bosses,92100000,2011-07-08,35000000,117538559,212417601,177417601,506.90743142857144
212,Paranormal Activity 3,103000000,2011-10-21,5000000,104028807,207039844,202039844,4040.79688
213,Gnomeo and Juliet,94000000,2011-02-11,36000000,99967670,193737977,157737977,438.16104722222224
214,Hugo,111900000,2011-11-23,180000000,73864507,180047784,47784,0.026546666666666666
215,Hop,75900000,2011-04-01,63000000,108085305,188657593,125657593,199.45649682539684
216,War Horse,97700000,2011-12-25,70000000,79883359,156815529,86815529,124.02218428571427
217,The Descendants,94700000,2011-11-16,20000000,82624961,175507800,155507800,777.539
218,In Time,136400000,2011-10-28,35000000,37553932,165103952,130103952,371.72557714285716
219,Zookeeper,89500000,2011-07-08,80000000,80360866,170805525,90805525,113.50690625
220,The Muppets,76600000,2011-11-23,45000000,88625922,160971922,115971922,257.7153822222222
221,Limitless,82600000,2011-03-18,27000000,79249455,155564919,128564919,476.16636666666665
222,Johnny English Reborn,151800000,2011-10-21,45000000,8406711,164640401,119640401,265.8675577777778
223,Final Destination 5,115300000,2011-08-12,40000000,42587643,155011165,115011165,287.5279125
224,Tower Heist,74900000,2011-11-04,85000000,78046570,150422946,65422946,76.96817176470589
225,Midnight in Paris,94300000,2011-05-20,30000000,56816662,162502774,132502774,441.67591333333337
226,Happy Feet Two,86400000,2011-11-18,135000000,64006466,157956466,22956466,17.00478962962963
227,Jack and Jill,75500000,2011-11-11,79000000,74158157,150519217,71519217,90.53065443037974
228,Friends with Benefits,93700000,2011-07-22,35000000,55802754,146595891,111595891,318.84540285714286
229,No Strings Attached,78600000,2011-01-21,25000000,70662220,149228078,124228078,496.912312
230,Arthur Christmas,101000000,2011-11-23,85000000,46462469,149717124,64717124,76.13779294117647
231,Source Code,92600000,2011-04-01,32000000,54712227,140428499,108428499,338.83905937500003
232,Contagion,59800000,2011-09-09,60000000,75658097,137551594,77551594,129.25265666666667
233,The Artist,88800000,2011-11-25,16000000,44667095,128256712,112256712,701.6044499999999
234,Unknown,67099999,2011-02-18,40000000,63686397,136123083,96123083,240.30770750000002
236,The Adjustment Bureau,65400000,2011-03-04,50200000,62495645,126931325,76731325,152.8512450199203
237,We Bought a Zoo,44500000,2011-12-23,50000000,75624550,118729073,68729073,137.458146
238,Water for Elephants,58400000,2011-04-22,38000000,58709717,116809717,78809717,207.39399210526318
239,The Iron Lady,84900000,2012-01-13,14000000,29959436,115592104,101592104,725.6578857142857
240,Moneyball,34600000,2011-09-23,50000000,75605492,111300835,61300835,122.60167
241,Sanctum,85400000,2011-02-04,30000000,23209310,108957098,78957098,263.1903266666667
242,Justin Bieber: Never Say Never,26000000,2011-02-11,13000000,73013910,99034125,86034125,661.8009615384615
243,Paul,60600000,2011-03-18,40000000,37412945,101162106,61162106,152.90526499999999
244,Scream 4,59000000,2011-04-15,40000000,38180928,95989590,55989590,139.973975
245,Insidious,43000000,2011-04-01,1500000,54009150,99870886,98370886,6558.059066666667
246,The Rite,63000000,2011-01-28,37000000,33047633,97143987,60143987,162.5513162162162
247,Dolphin Tale,23100000,2011-09-23,37000000,72286779,96068724,59068724,159.6452
248,Season of the Witch,66800000,2011-01-07,40000000,24827228,91126600,51126600,127.8165
249,Sucker Punch,53400000,2011-03-25,75000000,36392502,89758389,14758389,19.677852
250,Red Riding Hood,51500000,2011-03-11,42000000,37662162,91678442,49678442,118.28200476190476
251,Spy Kids: All the Time in the World,47000000,2011-08-19,27000000,38536376,80681183,53681183,198.8191962962963
252,J. Edgar,47600000,2011-11-09,35000000,37306030,84606030,49606030,141.7315142857143
253,Hall Pass,38100000,2011-02-25,68000000,45060734,87173475,19173475,28.19628676470588
254,"Big Mommas: Like Father, Like Son",44800000,2011-02-18,32000000,37915414,82332450,50332450,157.28890625
255,Abduction,54000000,2011-09-23,35000000,28087155,86648359,51648359,147.56674
256,Priest,49200000,2011-05-13,60000000,29136626,84154026,24154026,40.25671
257,The Mechanic,47000000,2011-01-28,42500000,29121498,76347393,33847393,79.64092470588236
258,The Ides of March,35000000,2011-10-07,23000000,40962534,77735925,54735925,237.98228260869564
259,The Change-Up,38400000,2011-08-05,52000000,37243418,75997067,23997067,46.14820576923077
260,The Lincoln Lawyer,17000000,2011-03-18,40000000,58009200,87145086,47145086,117.86271500000001
261,Diary of a Wimpy Kid: Rodrick Rules,19700000,2011-03-25,18000000,52698535,73695194,55695194,309.41774444444445
262,Larry Crowne,36400000,2011-07-01,30000000,35608245,61449135,31449135,104.83045
263,The Dilemma,21200000,2011-01-14,70000000,48475290,70546865,546865,0.7812357142857143
264,The Darkest Hour,43200000,2011-12-25,34800000,21443494,62831715,28031715,80.55090517241379
265,Hanna,23500000,2011-04-08,30000000,40259119,65343694,35343694,117.81231333333334
266,Colombiana,24300000,2011-08-26,40000000,36665854,72295262,32295262,80.738155
267,Something Borrowed,21100000,2011-05-06,35000000,39046489,65084116,30084116,85.95461714285715
268,One Day,45500000,2011-08-19,15000000,13843771,59168692,44168692,294.45794666666666
269,Killer Elite,31300000,2011-09-23,70000000,25124986,65409046,-4590954,-6.558505714285714
270,The Tree of Life,41000000,2011-05-27,35000000,13305665,61721826,26721826,76.34807428571429
271,Winnie the Pooh,23200000,2011-07-15,30000000,26692846,50145607,20145607,67.15202333333333
272,Soul Surfer,3200000,2011-04-08,18000000,43853424,47158652,29158652,161.9925111111111
273,The Debt,14500000,2011-08-31,20000000,31177548,46604054,26604054,133.02027
274,Beastly,15300000,2011-03-04,17000000,27865571,38028230,21028230,123.6954705882353
275,30 Minutes or Less,3500000,2011-08-12,28000000,37053924,40966716,12966716,46.3097
276,The Roommate,3200000,2011-02-04,16000000,37300107,52545707,36545707,228.41066875
277,Shark Night 3D,21300000,2011-09-02,25000000,18877153,18877153,-6122847,-24.491388
278,Monte Carlo,16500000,2011-07-01,20000000,23186769,39686769,19686769,98.43384499999999
279,50/50,4200000,2011-09-30,8000000,35016118,41334735,33334735,416.6841875
280,Mars Needs Moms,17600000,2011-03-11,150000000,21392758,39549758,-110450242,-73.63349466666666
281,Dream House,17200000,2011-09-30,50000000,21302340,41642166,-8357834,-16.715668
282,Jumping the Broom,415000,2011-05-06,7000000,37295394,38158601,31158601,445.12287142857144
283,Don't Be Afraid of the Dark,12900000,2011-08-26,25000000,24046682,39126427,14126427,56.505708
284,A Very Harold & Kumar 3D Christmas,326000,2011-11-04,20000000,35061031,36265745,16265745,81.328725
285,My Week with Marilyn,20500000,2011-11-23,10000000,14597405,34240572,24240572,242.40572
286,The Sitter,4500000,2011-12-09,25000000,30542576,38749404,13749404,54.99761600000001
287,Courageous,0,2011-09-30,2000000,34522221,35185884,33185884,1659.2942
288,I Don't Know How She Does It,20900000,2011-09-16,24000000,9659074,24474463,474463,1.9769291666666668
289,What's Your Number?,16399999,2011-09-30,20000000,14011084,30163785,10163785,50.81892500000001
290,Drive Angry,18200000,2011-02-25,50000000,10721033,41042583,-8957417,-17.914834
291,A Dangerous Method,21800000,2011-11-23,20000000,5702083,14807531,-5192469,-25.962345
292,The Eagle,7600000,2011-02-11,25000000,19490041,38993548,13993548,55.974192
293,Apollo 18,7900000,2011-09-02,5000000,17686929,26517819,21517819,430.35638
294,Biutiful,20000000,2011-01-28,35000000,5101237,24687524,-10312476,-29.46421714285714
295,Your Highness,3300000,2011-04-08,50000000,21596445,26121638,-23878362,-47.756724
296,Our Idiot Brother,0,2011-08-26,5000000,24814830,25861249,20861249,417.22498
297,The Rum Diary,10800000,2011-10-28,45000000,13109815,21544732,-23455268,-52.122817777777776
298,Warrior,9400000,2011-09-09,25000000,13657115,24215385,-784615,-3.13846
299,Young Adult,6600000,2011-12-09,12000000,16311571,22750356,10750356,89.5863
300,The Guard,14200000,2011-07-29,6000000,5359774,21197454,15197454,253.29090000000002
301,Margin Call,14200000,2011-10-21,3400000,5353586,20433227,17033227,500.9772647058823
302,Shame,13800000,2011-12-02,6500000,4002293,20412841,13912841,214.04370769230766
303,The Last Godfather,16600000,2011-04-01,13400000,164247,164247,-13235753,-98.77427611940298
304,Melancholia,12900000,2011-11-11,9400000,3030848,21817298,12417298,132.09891489361704
305,The Conspirator,3900000,2011-04-15,25000000,11538204,15907411,-9092589,-36.370356
306,Anonymous,10900000,2011-10-28,27500000,4463292,15815509,-11684491,-42.48905818181819
307,Beginners,8500000,2011-06-03,3200000,5790894,14314407,11114407,347.32521875
308,Snow Flower and the Secret Fan,10000000,2011-07-15,6000000,1348205,11348205,5348205,89.13674999999999
309,Le Havre,9900000,2011-10-21,5500000,611709,13480196,7980196,145.09447272727272
310,Prom,0,2011-04-29,8000000,10130219,10763183,2763183,34.5397875
311,Point Blank,8500000,1967-09-18,3000000,0,0,-3000000,-100.0
312,Winter in Wartime,8700000,2011-03-18,5800000,542860,9662214,3862214,66.58989655172414
313,The Big Year,244000,2011-10-14,41000000,7204138,7684524,-33315476,-81.25725853658537
314,The Beaver,6300000,2011-05-06,21000000,970816,5046038,-15953962,-75.97124761904762
315,Take Me Home Tonight,0,2011-03-04,19000000,6928068,7576604,-11423396,-60.12313684210526
316,Cedar Rapids,0,2011-02-11,10000000,6861102,7862131,-2137869,-21.37869
317,We Need to Talk About Kevin,4300000,2012-01-13,7000000,1738692,10765283,3765283,53.78975714285714
318,Attack the Block,4800000,2011-07-29,13000000,1024175,6459183,-6540817,-50.31397692307692
319,Dylan Dog: Dead of Night,3400000,2011-04-29,20000000,1186538,6093725,-13906275,-69.531375
320,Like Crazy,336000,2011-10-28,250000,3395391,3728400,3478400,1391.3600000000001
321,Martha Marcy May Marlene,548000,2011-10-21,1000000,2981038,5438911,4438911,443.8911
322,Fireflies in the Garden,3300000,2011-10-14,8000000,36884,3587191,-4412809,-55.160112500000004
323,Machine Gun Preacher,2800000,2011-09-23,30000000,538690,3721988,-26278012,-87.59337333333333
324,Take Shelter,1400000,2011-09-30,4750000,1728953,4972016,222016,4.674021052631579
325,Everything Must Go,0,2011-05-13,5000000,2712131,2821010,-2178990,-43.5798
326,Brighton Rock,1600000,2011-08-26,11000000,229653,229653,-10770347,-97.91224545454546
327,Another Earth,456000,2011-07-22,175000,1321194,2102779,1927779,1101.588
328,A Better Life,0,2011-06-24,10000000,1759252,1884251,-8115749,-81.15749
329,The Art of Getting By,0,2011-06-17,4000000,1430241,1989035,-2010965,-50.274125000000005
330,The Devil's Double,0,2011-07-29,19100000,1361512,5965646,-13134354,-68.76625130890052
331,Red State,0,2011-09-23,4000000,1065429,1983596,-2016404,-50.4101
332,There Be Dragons,0,2011-05-06,36000000,1069334,4020990,-31979010,-88.83058333333334
333,Meek's Cutoff,0,2011-04-08,2000000,977772,1869928,-130072,-6.5036
334,Submarine,397000,2011-06-03,1900000,467602,4581937,2681937,141.15457894736844
335,Higher Ground,0,2011-08-23,1800000,841056,842693,-957307,-53.183722222222215
336,POM Wonderful Presents: The Greatest Movie Ever Sold,0,2011-04-22,1800000,638476,783733,-1016267,-56.459277777777785
337,Blackthorn,423000,2011-10-07,4500000,200558,1217307,-3282693,-72.94873333333334
338,The Future,0,2011-07-29,1000000,568662,1239174,239174,23.9174
339,Dum Maaro Dum,0,2011-04-22,5200000,564489,11633427,6433427,123.71974999999999
340,Circumstance,0,2011-08-26,900000,454121,958978,58978,6.553111111111111
341,The Other Woman,427000,2014-04-25,40000000,83911193,195111193,155111193,387.7779825
342,Hesher,0,2011-05-13,7000000,382946,382946,-6617054,-94.52934285714286
343,Another Happy Day,347000,2011-11-18,4000000,9120,978527,-3021473,-75.536825
344,Super,0,2011-04-01,2500000,327716,593933,-1906067,-76.24268
345,Rubber,0,2011-04-01,500000,100370,680914,180914,36.1828
346,Beautiful Boy,0,2018-10-12,25000000,7634767,13031424,-11968576,-47.874304
347,Margaret,0,2011-09-30,14000000,47185,623292,-13376708,-95.54791428571428
348,Stake Land,0,2011-04-22,4000000,33245,679482,-3320518,-83.01294999999999
349,The Son of No One,0,2011-11-04,15000000,30680,1148578,-13851422,-92.34281333333332
350,5 Days of War,0,2011-08-19,12000000,17479,87793,-11912207,-99.26839166666667
351,Blood Ties,0,2014-03-21,26000000,42472,2923959,-23076041,-88.75400384615385
352,Skyfall,804200000,2012-11-08,200000000,304360277,1110526981,910526981,455.2634905
353,The Dark Knight Rises,636800000,2012-07-20,275000000,448139099,1084439099,809439099,294.3414905454545
354,The Hobbit: An Unexpected Journey,718100000,2012-12-14,250000000,303003568,1017003568,767003568,306.80142720000003
355,Ice Age: Continental Drift,715900000,2012-07-13,95000000,161321843,879765137,784765137,826.068565263158
356,The Amazing Spider-Man,495900000,2012-07-03,220000000,262030663,757890267,537890267,244.4955759090909
357,Madagascar 3: Europe's Most Wanted,530500000,2012-06-08,145000000,216391482,746921271,601921271,415.1181179310345
358,The Hunger Games,286400000,2012-03-23,80000000,408010692,677923379,597923379,747.40422375
359,Life of Pi,484000000,2012-11-21,120000000,124987022,620912003,500912003,417.42666916666667
360,Ted,330600000,2012-06-29,50000000,218665740,556016627,506016627,1012.0332539999999
361,Brave,303200000,2012-06-22,185000000,237282182,554606532,369606532,199.7873145945946
362,Wreck-It Ralph,281800000,2012-11-02,165000000,189412677,496511521,331511521,200.91607333333332
363,Django Unchained,262600000,2012-12-25,100000000,162805434,449948323,349948323,349.948323
364,Prometheus,276900000,2012-06-08,125000000,126477084,402448265,277448265,221.95861200000002
365,Snow White and the Huntsman,241300000,2012-06-01,170000000,155136755,401021746,231021746,135.89514470588236
366,Taken 2,236300000,2012-10-05,45000000,139854287,377807404,332807404,739.572008888889
367,Hotel Transylvania,210100000,2012-09-28,85000000,148313048,378505812,293505812,345.30095529411767
368,Journey 2: The Mysterious Island,231400000,2012-02-10,79000000,103860290,318146162,239146162,302.71666075949366
369,The Expendables 2,229900000,2012-08-17,100000000,85028192,311979256,211979256,211.979256
370,Rise of the Guardians,203500000,2012-11-21,145000000,103412758,306900902,161900902,111.65579448275862
371,Wrath of the Titans,221600000,2012-03-30,150000000,83670083,305270083,155270083,103.51338866666666
372,Battleship,237600000,2012-05-18,220000000,65233400,313477717,93477717,42.48987136363636
373,John Carter,211100000,2012-03-09,275000000,73058679,282778100,7778100,2.8284
374,The Bourne Legacy,162900000,2012-08-10,125000000,113203870,280355920,155355920,124.28473600000001
375,Lincoln,93100000,2012-11-09,65000000,182207973,273346281,208346281,320.53274
376,Dark Shadows,165800000,2012-05-11,150000000,79727149,238202668,88202668,58.80177866666667
377,Resident Evil: Retribution,197700000,2012-09-14,65000000,42345531,240647629,175647629,270.2271215384616
378,Silver Linings Playbook,104300000,2012-11-16,21000000,132092958,236412453,215412453,1025.7735857142857
379,American Reunion,178000000,2012-04-06,50000000,56758835,236799211,186799211,373.598422
380,Argo,96300000,2012-10-12,44500000,136025503,227140757,182640757,410.42866741573033
381,Jack Reacher,138300000,2012-12-21,60000000,80070736,217370736,157370736,262.28456
382,Safe House,81700000,2012-02-10,85000000,126181630,208542162,123542162,145.34372
383,21 Jump Street,63100000,2012-03-16,42000000,138447667,202812429,160812429,382.88673571428575
384,The Vow,71100000,2012-02-10,30000000,125014030,197618160,167618160,558.7271999999999
385,Mirror Mirror,118100000,2012-03-30,85000000,64935167,173613482,88613482,104.25115529411764
386,The Impossible,161300000,2012-12-21,40000000,19019882,169590606,129590606,323.976515
387,The Dictator,119700000,2012-05-16,65000000,59650222,180148897,115148897,177.15214923076923
388,Looper,110000000,2012-09-28,30000000,66486205,170466405,140466405,468.22135
389,Magic Mike,53500000,2012-06-29,7000000,113721571,170549753,163549753,2336.4250428571427
390,Flight,68000000,2012-11-02,31000000,93772375,160558438,129558438,417.9304451612904
391,This Means War,101700000,2012-02-17,65000000,54760791,156974557,91974557,141.49931846153848
392,Paranormal Activity 4,88900000,2012-10-19,5000000,53900335,142817992,137817992,2756.35984
393,Step Up Revolution,105400000,2012-07-27,33000000,35074677,165552290,132552290,401.67360606060606
394,The Best Exotic Marigold Hotel,90400000,2012-05-04,10000000,46383639,134639780,124639780,1246.3978
395,Zero Dark Thirty,37100000,2012-12-19,52500000,95720716,134612435,82112435,156.4046380952381
396,Ghost Rider: Spirit of Vengeance,80800000,2012-02-17,57000000,51774002,149217355,92217355,161.78483333333332
397,Cloud Atlas,103400000,2012-10-26,102000000,27108272,130673154,28673154,28.110935294117645
398,The Woman in Black,73400000,2012-02-03,15000000,54333290,128955898,113955898,759.7059866666667
399,The Pirates! Band of Misfits,92000000,2012-04-27,55000000,31051126,136143605,81143605,147.53382727272728
400,Parental Guidance,42500000,2012-12-25,25000000,77267296,120832383,95832383,383.329532
401,Abraham Lincoln: Vampire Hunter,79000000,2012-06-22,67500000,37519139,137489730,69989730,103.68848888888888
402,Pitch Perfect,50300000,2012-09-28,17000000,65001093,116044347,99044347,582.613805882353
403,Hope Springs,50700000,2012-08-08,30000000,63536011,133085295,103085295,343.61765
404,ParaNorman,51100000,2012-08-17,60000000,56003051,108119662,48119662,80.19943666666667
405,The Campaign,18000000,2012-08-10,95000000,86907746,104907746,9907746,10.429206315789475
406,Project X,48000000,2012-03-02,12000000,54731865,103028188,91028188,758.5682333333334
407,The Devil Inside,48500000,2012-01-06,1000000,53262945,101759490,100759490,10075.949
408,The Lucky One,38900000,2012-04-20,25000000,60457138,96633833,71633833,286.535332
409,Contraband,29700000,2012-01-13,25000000,66528000,98406855,73406855,293.62742000000003
410,Think Like a Man,4500000,2012-04-20,12000000,91547205,113373764,101373764,844.7813666666667
411,The Possession,36300000,2012-08-31,14000000,49130588,82925064,68925064,492.32188571428577
412,What to Expect When You're Expecting,43200000,2012-05-18,37500000,41152203,88473016,50973016,135.92804266666667
413,Frankenweenie,46200000,2012-10-05,39000000,35287788,81150788,42150788,108.07894358974359
414,Act of Valor,11300000,2012-02-24,12000000,70012847,82497035,70497035,587.4752916666667
415,Sinister,29600000,2012-10-12,3000000,48086903,87727807,84727807,2824.2602333333334
416,The Grey,25700000,2012-01-27,25000000,51580136,81249176,56249176,224.996704
417,Diary of a Wimpy Kid: Dog Days,28100000,2012-08-03,22000000,49008662,77229695,55229695,251.0440681818182
418,To Rome with Love,56600000,2012-06-22,21500000,16684352,74326015,52826015,245.70239534883723
419,Here Comes the Boom,27800000,2012-10-12,42000000,45290318,73239258,31239258,74.37918571428571
420,Anna Karenina,56100000,2012-11-16,49000000,12816367,71004627,22004627,44.90740204081632
421,The Watch,32900000,2012-07-27,55000000,34353000,67130045,12130045,22.054627272727274
422,Moonrise Kingdom,22800000,2012-05-25,16000000,45512466,68848446,52848446,330.3027875
423,Tyler Perry's Madea's Witness Protection,1200000,2012-06-29,20000000,65653242,66950887,46950887,234.75443500000003
424,The Cabin in the Woods,24400000,2012-04-13,30000000,42073277,70689968,40689968,135.63322666666667
425,Rock of Ages,20900000,2012-06-15,70000000,38518613,61031932,-8968068,-12.811525714285715
426,That's My Boy,20800000,2012-06-15,57500000,36931089,58085235,585235,1.0178
427,The Odd Life of Timothy Green,4200000,2012-08-15,40000000,51853450,55249159,15249159,38.1228975
428,The Three Stooges,10500000,2012-04-13,30000000,44338224,54052249,24052249,80.17416333333334
429,The Five-Year Engagement,25100000,2012-04-27,30000000,28700285,61623819,31623819,105.41273
430,Lawless,16300000,2012-08-29,26000000,37397291,54393687,28393687,109.20648846153847
431,Silent Hill: Revelation 3D,34800000,2012-10-26,20000000,17530219,55975672,35975672,179.87836
432,Red Tails,489000,2012-01-20,58000000,49876377,50365498,-7634502,-13.16293448275862
433,Trouble with the Curve,13200000,2012-09-21,60000000,35763137,47818913,-12181087,-20.301811666666666
434,End of Watch,7100000,2012-09-21,15000000,41003371,57586606,42586606,283.91070666666667
435,Man on a Ledge,27600000,2012-01-27,42000000,18620000,49621440,7621440,18.146285714285714
436,The Guilt Trip,4700000,2012-12-19,40000000,37134215,41294674,1294674,3.2366850000000005
437,Killing Them Softly,22900000,2012-11-30,15000000,14945541,39238443,24238443,161.58962
438,Chernobyl Diaries,19000000,2012-05-25,1000000,18119640,42411721,41411721,4141.1721
439,Dredd,22200000,2012-09-21,45000000,13414714,41467606,-3532394,-7.849764444444444
440,Tyler Perry's Good Deeds,553000,2012-02-24,14000000,35025791,35579177,21579177,154.13697857142856
441,Arbitrage,27600000,2012-09-14,12000000,7919574,35830713,23830713,198.58927500000001
442,Alex Cross,8700000,2012-10-19,35000000,25888412,35426759,426759,1.2193114285714286
443,The Perks of Being a Wallflower,15600000,2012-09-21,13000000,17742948,33069303,20069303,154.37925384615386
444,Haywire,14400000,2012-01-20,23000000,18942396,36374700,13374700,58.15086956521739
445,Katy Perry: Part of Me,7400000,2012-07-05,12000000,25326071,32700439,20700439,172.50365833333333
446,Lockout,17900000,2012-04-13,20000000,14326865,33943049,13943049,69.71524500000001
447,Joyful Noise,226000,2012-01-13,27500000,30932113,31157914,3657914,13.301505454545454
448,Premium Rush,10800000,2012-08-24,35000000,20275446,31393201,-3606799,-10.30514
449,The Raven,13600000,2012-04-27,26000000,16008272,30601801,4601801,17.699234615384615
450,The Master,11900000,2012-09-14,37500000,16247159,50647416,13147416,35.059776
451,Big Miracle,4600000,2012-02-03,40000000,20157300,25268680,-14731320,-36.828300000000006
452,A Thousand Words,3600000,2012-03-09,40000000,18450127,20790486,-19209514,-48.023785000000004
453,Wanderlust,4200000,2012-02-24,32500000,17288155,24159934,-8340066,-25.66174153846154
454,Beasts of the Southern Wild,8300000,2012-06-27,1800000,12795746,23265132,21465132,1192.5073333333335
455,Polisse,20200000,2012-05-18,8900000,176988,22744132,13844132,155.55204494382022
456,Amour,13100000,2012-12-19,9700000,6738954,36787044,27087044,279.24787628865977
457,The Man with the Iron Fists,4099999,2012-11-02,15000000,15634090,22018988,7018988,46.79325333333333
458,Seven Psychopaths,4400000,2012-10-12,13500000,15024049,33035736,19535736,144.70915555555555
459,The Cold Light of Day,13100000,2012-09-07,20000000,3763583,25361206,5361206,26.806029999999996
460,The Words,1700000,2012-09-07,6000000,11494838,16369708,10369708,172.82846666666666
461,Playing for Keeps,0,1986-10-03,35000000,2000000,2000000,-33000000,-94.28571428571428
462,Silent House,347000,2012-03-09,2000000,12739737,16610760,14610760,730.538
463,People Like Us,0,2012-06-29,16000000,12431792,12617472,-3382528,-21.140800000000002
464,Bachelorette,11500000,2012-09-07,3000000,446770,12577401,9577401,319.24670000000003
465,Fun Size,2000000,2012-10-26,14000000,9409538,11166615,-2833385,-20.238464285714286
466,Seeking a Friend for the End of the World,2600000,2012-06-22,10000000,7078738,11766959,1766959,17.66959
467,The Apparition,4700000,2012-08-24,17000000,4936819,10637281,-6362719,-37.42775882352941
468,Bernie,0,2012-04-27,6000000,9204489,10106975,4106975,68.44958333333334
469,The Sessions,3100000,2012-10-19,1000000,6002451,11495204,10495204,1049.5203999999999
470,On the Road,8000000,2013-03-22,25000000,720828,9313302,-15686698,-62.746792
471,The Collection,0,2012-11-30,10000000,6810754,8890094,-1109906,-11.09906
472,Chasing Mavericks,600,2012-10-26,20000000,6002756,8300821,-11699179,-58.495895
473,Albert Nobbs,2600000,2011-12-21,7500000,3014696,8539003,1039003,13.853373333333332
474,Won't Back Down,0,2012-09-28,19000000,5310554,5745503,-13254497,-69.76051052631578
475,"Jeff, Who Lives at Home",148000,2012-03-16,10000000,4269426,4708127,-5291873,-52.918730000000004
476,Safety Not Guaranteed,0,2012-06-08,750000,4010957,4422318,3672318,489.64239999999995
477,Killer Joe,1700000,2012-07-27,10000000,1291645,4659110,-5340890,-53.4089
478,Robot & Frank,0,2012-08-17,2500000,3317468,4934356,2434356,97.37424
479,Celeste and Jesse Forever,0,2012-08-03,840000,3103407,3787689,2947689,350.91535714285715
480,Jab Tak Hai Jaan,0,2012-11-13,9200000,3047539,5806666,-3393334,-36.8840652173913
481,Samsara,0,2012-08-24,4000000,2672413,5966671,1966671,49.166775
482,Your Sister's Sister,0,2012-06-15,120000,1597486,3090593,2970593,2475.494166666667
483,The Paperboy,661000,2012-10-05,12500000,677200,4027663,-8472337,-67.77869600000001
484,A Little Bit of Heaven,1300000,2012-05-04,12500000,10011,1100287,-11399713,-91.197704
485,Coriolanus,315000,2012-01-20,10000000,749641,2179623,-7820377,-78.20376999999999
486,Damsels in Distress,0,2012-04-06,3000000,1007535,1324299,-1675701,-55.856700000000004
487,Darling Companion,0,2012-04-20,12000000,793352,1200346,-10799654,-89.99711666666667
488,Holy Motors,0,2012-10-17,4000000,641054,4230426,230426,5.76065
489,Sound of My Voice,0,2012-04-27,135000,408015,429448,294448,218.1096296296296
490,Khiladi 786,0,2012-12-07,5600000,385422,14683763,9083763,162.21005357142857
491,Compliance,0,2012-08-17,270000,319285,830700,560700,207.66666666666666
492,Kill List,143000,2012-02-03,800000,29063,462206,-337794,-42.224250000000005
493,High School,0,2012-06-01,10000000,139034,248133,-9751867,-97.51867
494,The Innkeepers,0,2012-02-03,750000,78396,1011535,261535,34.87133333333333
495,The First Time,0,2012-10-19,2000000,17061,17061,-1982939,-99.14695
496,Frozen,875700000,2013-11-22,150000000,400738009,1272469910,1122469910,748.3132733333333
497,Iron Man 3,805800000,2013-05-03,200000000,408992272,1215392272,1015392272,507.696136
498,Despicable Me 2,602700000,2013-07-03,76000000,368065385,975216835,899216835,1183.1800460526315
499,The Hobbit: The Desolation of Smaug,700000000,2013-12-13,250000000,258366855,960366855,710366855,284.14674199999996
500,The Hunger Games: Catching Fire,440300000,2013-11-22,130000000,424668047,864868047,734868047,565.2831130769231
501,Monsters University,475700000,2013-06-21,200000000,268488329,743588329,543588329,271.79416449999997
502,Gravity,449100000,2013-10-04,110000000,274092705,693698673,583698673,530.6351572727273
503,Man of Steel,377000000,2013-06-14,225000000,291045518,667999518,442999518,196.88867466666667
504,Thor: The Dark World,438200000,2013-11-08,150000000,206362140,644602516,494602516,329.7350106666667
505,The Croods,400000000,2013-03-22,135000000,187168425,573068425,438068425,324.4951296296296
506,World War Z,337600000,2013-06-21,190000000,202359711,531514650,341514650,179.74455263157896
507,Star Trek Into Darkness,238600000,2013-05-16,190000000,228778661,467381584,277381584,145.99030736842104
508,The Wolverine,282300000,2013-07-26,115000000,132556852,416456852,301456852,262.1363930434783
509,Pacific Rim,309200000,2013-07-12,190000000,101802906,411002906,221002906,116.31731894736843
510,The Wolf of Wall Street,275100000,2013-12-25,100000000,116900694,389870414,289870414,289.870414
511,G.I. Joe: Retaliation,253200000,2013-03-27,140000000,122523060,375740705,235740705,168.38621785714284
512,Now You See Me,234000000,2013-05-31,75000000,117723989,342769200,267769200,357.0256
513,The Smurfs 2,276500000,2013-07-31,110000000,71017784,348547523,238547523,216.86138454545457
514,The Conjuring,182100000,2013-07-19,20000000,137400141,318000141,298000141,1490.000705
515,A Good Day to Die Hard,237300000,2013-02-14,92000000,67349198,304249198,212249198,230.70565
516,Oblivion,197100000,2013-04-19,120000000,89107235,287916633,167916633,139.93052749999998
517,Elysium,193100000,2013-08-09,120000000,93050117,286192091,166192091,138.49340916666665
518,Turbo,199500000,2013-07-17,135000000,83028130,286896578,151896578,112.51598370370371
519,Cloudy with a Chance of Meatballs 2,154500000,2013-09-27,78000000,119793567,274392649,196392649,251.78544743589742
520,We're the Millers,119600000,2013-08-07,37000000,150394119,267816276,230816276,623.827772972973
521,Epic,160900000,2013-05-24,100000000,107518682,262794441,162794441,162.794441
522,The Lone Ranger,171200000,2013-07-02,275000000,89302115,260002115,-14997885,-5.453776363636364
523,American Hustle,101100000,2013-12-13,40000000,150117807,257878294,217878294,544.695735
524,Grown Ups 2,113300000,2013-07-12,80000000,133668525,247023808,167023808,208.77976
525,After Earth,183300000,2013-05-31,130000000,60522097,251499665,121499665,93.46128076923077
526,The Heat,70300000,2013-06-28,43000000,159581587,229727774,186727774,434.25063720930234
527,Captain Phillips,111700000,2013-10-11,55000000,107136417,220648184,165648184,301.1785163636364
528,White House Down,132300000,2013-06-28,150000000,73103784,205440387,55440387,36.960258
529,Percy Jackson: Sea of Monsters,131300000,2013-08-07,90000000,68559554,200859554,110859554,123.17728222222222
530,Jack the Giant Slayer,132500000,2013-03-01,195000000,65187603,197687603,2687603,1.3782579487179487
531,The Secret Life of Walter Mitty,129900000,2013-12-25,91000000,58236838,187861183,96861183,106.44086043956045
532,12 Years a Slave,131100000,2013-10-18,20000000,56671993,181025343,161025343,805.1267149999999
533,Lee Daniels' The Butler,60000000,2013-08-16,30000000,116632095,177025498,147025498,490.08499333333333
534,Identity Thief,39500000,2013-02-08,35000000,134506920,175361578,140361578,401.03308000000004
535,Anchorman 2: The Legend Continues,46300000,2013-12-18,50000000,127352707,172185754,122185754,244.371508
536,Olympus Has Fallen,71300000,2013-03-22,70000000,98927592,172878928,102878928,146.96989714285715
537,Insidious Chapter 2,78300000,2013-09-13,5000000,83586447,161921515,156921515,3138.4303
538,Lone Survivor,29700000,2013-12-25,40000000,125095601,149804632,109804632,274.51158000000004
539,Jackass Presents: Bad Grandpa,49800000,2013-10-25,15000000,102003019,160903019,145903019,972.6867933333333
540,47 Ronin,113400000,2013-12-25,175000000,38362475,151716815,-23283185,-13.304677142857143
541,Mama,74800000,2013-01-18,15000000,71628180,148095566,133095566,887.3037733333333
542,Escape Plan,112200000,2013-10-18,70000000,25135965,103735965,33735965,48.19423571428572
543,Last Vegas,70500000,2013-01-28,28000000,63914167,112914167,84914167,303.2648821428571
544,2 Guns,56300000,2013-08-02,61000000,75612460,132493015,71493015,117.20166393442624
545,Walking with Dinosaurs,90500000,2013-12-20,80000000,36076121,123368842,43368842,54.2110525
546,This is the End,24600000,2013-06-12,32000000,101470202,126539117,94539117,295.434740625
547,Ender's Game,63800000,2013-11-01,110000000,61737191,127983283,17983283,16.348439090909093
548,Prisoners,61100000,2013-09-20,46000000,61002302,113402302,67402302,146.52674347826087
549,Saving Mr. Banks,34600000,2013-12-13,35000000,83299761,114962525,79962525,228.46435714285715
550,Warm Bodies,50600000,2013-02-01,30000000,66380662,115121608,85121608,283.73869333333334
551,Free Birds,54600000,2013-11-01,55000000,55750480,110387072,55387072,100.70376727272728
552,Gangster Squad,59200000,2013-01-11,60000000,46000903,104100903,44100903,73.501505
553,Philomena,62400000,2013-11-22,12000000,37709979,98963392,86963392,724.6949333333333
554,Riddick,56300000,2013-09-06,38000000,42025135,94763758,56763758,149.37831052631577
555,Safe Haven,26200000,2013-02-14,28000000,71399120,94050951,66050951,235.8962535714286
556,Blue Jasmine,64099999,2013-07-26,18000000,33404871,102912961,84912961,471.7386722222222
557,The Mortal Instruments: City of Bones,64200000,2013-08-21,60000000,31165421,75965567,15965567,26.609278333333336
558,The Internship,48800000,2013-06-07,58000000,44672764,93672764,35672764,61.50476551724138
559,The Purge,24900000,2013-06-07,3000000,64473115,91266581,88266581,2942.2193666666667
560,Dhoom 3,80000000,2013-12-20,24000000,8031955,11723620,-12276380,-51.15158333333333
561,About Time,71800000,2013-11-01,12000000,15323921,89309178,77309178,644.24315
562,R.I.P.D.,44700000,2013-07-19,130000000,33618855,79076678,-50923322,-39.171786153846156
563,The Book Thief,55100000,2013-11-08,19000000,21488481,76086711,57086711,300.4563736842105
564,Escape From Planet Earth,17600000,2013-02-15,40000000,57012977,74156610,34156610,85.391525
565,August: Osage County,36500000,2013-12-25,25000000,37738810,50738810,25738810,102.95524
566,The Best Man Holiday,2300000,2013-11-15,17000000,70525195,72835710,55835710,328.44535294117645
567,The Counselor,54000000,2013-10-25,25000000,16973715,71009334,46009334,184.037336
568,The Call,16700000,2013-03-15,12800000,51872378,69821476,57021476,445.48028124999996
569,One Direction: This is Us,39700000,2013-08-30,10000000,28873374,68541786,58541786,585.41786
570,Runner Runner,43400000,2013-10-04,30000000,19316646,60512680,30512680,101.70893333333333
571,Kick-Ass 2,32000000,2013-08-16,28000000,28795985,63129909,35129909,125.46396071428572
572,A Haunted House,20100000,2013-01-11,2500000,40041683,59922558,57422558,2296.9023199999997
573,Quartet,41100000,2013-01-11,11000000,18388357,56178935,45178935,410.7175909090909
574,Dallas Buyers Club,27900000,2013-11-01,5000000,27298285,60611845,55611845,1112.2369
575,Tyler Perry's A Madea Christmas,853000,2013-12-13,25000000,52543354,52543354,27543354,110.17341599999999
576,Delivery Man,19300000,2013-11-22,22000000,30659817,70536870,48536870,220.62213636363634
577,The Last Stand,36300000,2013-01-18,30000000,12050299,48330757,18330757,61.10252333333334
578,21 and Over,22400000,2013-03-01,13000000,25682380,42195766,29195766,224.5828153846154
579,Texas Chainsaw 3D,12900000,2013-01-04,20000000,34341945,47666013,27666013,138.330065
580,The Big Wedding,24700000,2013-04-26,32500000,21819348,48425971,15925971,49.00298769230769
581,Parker,28600000,2013-01-25,35000000,17616641,48543388,13543388,38.695394285714286
582,The World's End,20100000,2013-08-23,20000000,26004851,47508505,27508505,137.54252499999998
583,Grudge Match,15100000,2013-12-25,40000000,29807260,69807260,29807260,74.51815
584,Homefront,22900000,2013-11-27,22000000,20158492,51695362,29695362,134.9789181818182
585,Snitch,0,2013-02-22,15000000,42930462,57907734,42907734,286.05156
587,Jobs,19800000,2013-08-16,18000000,16131410,43402515,25402515,141.12508333333332
588,The Place Beyond the Pines,14100000,2013-03-29,15000000,21403519,47011449,32011449,213.40966
589,Inside Llewyn Davis,19700000,2013-12-06,11000000,13248209,32943247,21943247,199.48406363636363
590,Mud,11000000,2013-04-26,10000000,21590086,31556959,21556959,215.56959
591,Movie 43,23600000,2013-01-25,10000000,8840453,31164747,21164747,211.64747
592,Kevin Hart: Let Me Explain,74000,2013-07-03,2500000,32244051,32327255,29827255,1193.0901999999999
593,Spring Breakers,17600000,2013-03-15,5000000,14124286,31149251,26149251,522.98502
594,Don Jon,6000000,2013-09-27,5500000,24477704,41268579,35768579,650.3378
595,Nebraska,10000000,2013-11-15,12000000,17654912,24761360,12761360,106.34466666666667
596,The Incredible Burt Wonderstone,4900000,2013-03-15,32000000,22537881,27392609,-4607391,-14.398096875
597,Mandela: Long Walk to Freedom,19000000,2013-11-29,35000000,8323085,29890402,-5109598,-14.59885142857143
598,Khumba,27200000,2013-12-06,15000000,0,20898221,5898221,39.32147333333334
599,Dark Skies,9000000,2013-02-22,3500000,17418667,27704111,24204111,691.5460285714286
600,Enough Said,7700000,2013-09-18,8000000,17550872,25621449,17621449,220.26811249999997
601,Trance,21900000,2013-04-05,16000000,2322593,22594052,6594052,41.212824999999995
603,Baggage Claim,887000,2013-09-27,8500000,21569509,22885836,14385836,169.2451294117647
604,The Sapphires,18000000,2013-03-22,9000000,2450867,20395040,11395040,126.61155555555557
605,Broken City,0,2013-01-18,35000000,19701164,34480045,-519955,-1.4855857142857143
606,You're Next,0,2013-08-23,1000000,18494006,26887177,25887177,2588.7177
607,Dead Man Down,7200000,2013-03-08,30000000,10895295,19599974,-10400026,-34.66675333333333
608,Admission,0,2013-03-22,13000000,18007317,18733666,5733666,44.10512307692308
609,Fruitvale Station,1300000,2013-07-12,900000,16098998,17549645,16649645,1849.9605555555554
610,Battle of the Year,7700000,2013-09-20,20000000,8888355,16723377,-3276623,-16.383115
611,Out of the Furnace,4300000,2013-12-04,22000000,11330849,15434375,-6565625,-29.843750000000004
612,The Last Exorcism Part II,0,2013-03-01,4000000,15179303,25448707,21448707,536.217675
613,Machete Kills,7000000,2013-10-11,20000000,8008161,18273009,-1726991,-8.634955
614,Paranoia,6400000,2013-08-16,40000000,7388654,16340767,-23659233,-59.1480825
615,Stoker,10400000,2013-03-01,12000000,1703125,12034913,34913,0.29094166666666665
616,Before Midnight,3100000,2013-05-24,3000000,8110621,23251930,20251930,675.0643333333334
617,Only God Forgives,9900000,2013-07-19,4800000,775849,4494560,-305440,-6.363333333333333
618,Bullet to the Head,0,2013-02-01,55000000,9489829,22597969,-32402031,-58.91278363636364
619,The Fifth Estate,5300000,2013-10-18,26000000,3254172,6154172,-19845828,-76.33010769230769
620,Upside Down,8000000,2013-03-15,50000000,102118,26387039,-23612961,-47.225922
621,Metallica Through the Never,4600000,2013-09-27,18000000,3419967,9082906,-8917094,-49.53941111111111
622,Black Nativity,436000,2013-11-27,17500000,7018188,7285135,-10214865,-58.37065714285714
623,The Spectacular Now,0,2013-08-02,2500000,6852971,6916951,4416951,176.67804
624,The Sweeney,6300000,2013-03-01,4500000,26345,8000366,3500366,77.7859111111111
625,Believe,0,2016-12-02,3500000,890303,890303,-2609697,-74.56277142857142
626,Frances Ha,0,2013-05-17,3000000,4067398,11262769,8262769,275.42563333333334
627,Yeh Jawaani Hai Deewani,0,2013-05-31,8300000,3827466,50827466,42527466,512.3791084337349
628,Mr. Nobody,3500000,2013-11-01,46500000,3622,22254,-46477746,-99.95214193548388
629,The East,99700,2013-05-31,6500000,2274649,3027956,-3472044,-53.416061538461534
630,The Christmas Candle,0,2013-11-15,7000000,1632000,1933829,-5066171,-72.37387142857142
631,All the Boys Love Mandy Lane,1900000,2013-10-11,750000,0,1960521,1210521,161.4028
632,Ain't Them Bodies Saints,635000,2013-08-16,5000000,391611,1075009,-3924991,-78.49982
633,The Reluctant Fundamentalist,0,2013-04-26,15000000,528731,528731,-14471269,-96.47512666666667
634,ABCD (Any Body Can Dance),0,2013-02-08,1900000,222098,10137234,8237234,433.53863157894733
635,The Canyons,0,2013-08-02,250000,59671,62375,-187625,-75.05
636,Transformers: Age of Extinction,858600000,2014-06-27,210000000,245439076,1104039076,894039076,425.7328933333333
637,The Hobbit: The Battle of the Five Armies,700900000,2014-12-17,250000000,255119788,945577621,695577621,278.23104839999996
638,Guardians of the Galaxy,440200000,2014-08-01,170000000,333172112,770867516,600867516,353.45148
639,Maleficent,517100000,2014-05-30,180000000,241407328,758536735,578536735,321.4092972222222
640,The Hunger Games: Mockingjay - Part 1,418200000,2014-11-21,125000000,337135885,766575131,641575131,513.2601048
641,X-Men: Days of Future Past,513900000,2014-05-23,200000000,233921534,747862775,547862775,273.9313875
642,Captain America: The Winter Soldier,454500000,2014-04-04,170000000,259746958,714401889,544401889,320.2364052941177
643,Dawn of the Planet of the Apes,502100000,2014-07-11,170000000,208545589,710644566,540644566,318.02621529411766
644,The Amazing Spider-Man 2,506100000,2014-05-02,200000000,202853933,708996336,508996336,254.498168
645,Interstellar,489400000,2014-11-05,165000000,188017894,666379375,501379375,303.8662878787879
646,Big Hero 6,435300000,2014-11-07,165000000,222527828,652127828,487127828,295.2289866666667
647,How to Train Your Dragon 2,444500000,2014-06-13,145000000,177002924,614586270,469586270,323.8526
648,American Sniper,197300000,2014-12-25,58000000,350126372,547326372,489326372,843.6661586206898
649,Rio 2,368600000,2014-04-11,130000000,131538435,492846291,362846291,279.11253153846155
650,Lucy,336700000,2014-07-25,40000000,126573960,457507776,417507776,1043.76944
651,Penguins of Madagascar,289700000,2014-11-26,132000000,83350911,366942531,234942531,177.9867659090909
652,Edge of Tomorrow,270300000,2014-06-06,178000000,100206256,370541256,192541256,108.16924494382023
653,Gone Girl,201600000,2014-10-03,61000000,167767189,368567189,307567189,504.20850655737706
654,Night at the Museum: Secret of the Tomb,249500000,2014-12-19,127000000,113746621,353756621,226756621,178.54852047244094
655,Noah,261399999,2014-03-28,130000000,101200044,352831065,222831065,171.40851153846154
656,The Maze Runner,245900000,2014-09-19,34000000,102427862,348319861,314319861,924.4701794117648
657,22 Jump Street,139600000,2014-06-13,50000000,191719337,331333876,281333876,562.6677520000001
658,Divergent,137900000,2014-03-21,85000000,150947895,276014965,191014965,224.7234882352941
659,Mr. Peabody & Sherman,164200000,2014-03-07,145000000,111506430,269806430,124806430,86.0734
660,Neighbors,120500000,2014-05-09,18000000,150086800,270944428,252944428,1405.2468222222221
661,Exodus: Gods and Kings,203200000,2014-12-12,140000000,65014513,268314513,128314513,91.65322357142857
662,Annabelle,172800000,2014-10-03,6500000,84273813,256862920,250362920,3851.7372307692303
663,The Imitation Game,142400000,2014-11-28,15000000,91125143,227740463,212740463,1418.2697533333335
664,Non-Stop,130600000,2014-02-28,50000000,91742160,222383055,172383055,344.76610999999997
665,Dracula Untold,160800000,2014-10-10,70000000,55991880,220241723,150241723,214.63103285714286
666,The Expendables 3,175300000,2014-08-15,100000000,39322544,209461378,109461378,109.461378
667,Into the Woods,85100000,2014-12-25,56200000,128002372,213116401,156916401,279.21067793594307
668,Need for Speed,159700000,2014-03-14,66000000,43568507,194169619,128169619,194.19639242424242
669,The Equalizer,90800000,2014-09-26,55000000,101530738,192903624,137903624,250.7338618181818
670,The Grand Budapest Hotel,115500000,2014-03-07,31000000,59076019,163981261,132981261,428.97180967741934
671,Dumb and Dumber To,83600000,2014-11-14,40000000,86208010,156553592,116553592,291.38398
672,Unbroken,47800000,2014-12-25,65000000,115637895,163527824,98527824,151.58126769230768
673,The Monuments Men,77000000,2014-02-07,70000000,78031620,158702748,88702748,126.71821142857142
674,Ride Along,19500000,2014-01-17,25000000,134202565,153733800,128733800,514.9352
675,Jack Ryan: Shadow Recruit,84900000,2014-01-17,60000000,50577412,131377412,71377412,118.96235333333334
676,Blended,81700000,2014-05-23,45000000,46290741,127990741,82990741,184.42386888888888
677,Sex Tape,87500000,2014-07-18,40000000,38543473,126069509,86069509,215.17377249999998
678,The Theory of Everything,87800000,2014-11-07,15000000,35893537,123327692,108327692,722.1846133333333
679,The Nut Job,56600000,2014-01-17,30000000,64251538,122529966,92529966,308.43322
680,Pompeii,94600000,2014-02-21,80000000,23169033,108469033,28469033,35.58629125
681,The Purge: Anarchy,40000000,2014-07-18,9000000,71562550,111534881,102534881,1139.2764555555555
682,The Boxtrolls,58400000,2014-09-26,60000000,50837305,111946251,51946251,86.577085
683,Horrible Bosses 2,53200000,2014-11-26,40000000,54445357,105945357,65945357,164.8633925
684,Ouija,52700000,2014-10-24,5000000,50856010,103300632,98300632,1966.01264
685,Transcendence,80000000,2014-04-18,100000000,23022309,103039258,3039258,3.039258
686,"Alexander and the Terrible, Horrible, No Good, Very Bad Day",34400000,2014-10-10,28000000,66954149,101379287,73379287,262.06888214285715
687,Heaven is for Real,9900000,2014-04-16,12000000,91386097,100916299,88916299,740.9691583333333
688,Tammy,16000000,2014-07-02,20000000,84525432,96407655,76407655,382.038275
689,Paranormal Activity: The Marked Ones,58400000,2014-01-03,5000000,32462372,90904854,85904854,1718.09708
690,The Hundred-Foot Journey,34600000,2014-08-08,22000000,54235441,94270488,72270488,328.5022181818182
691,John Wick,45700000,2014-10-24,30000000,43037835,76235001,46235001,154.11667
692,Snowpiercer,82200000,2014-06-27,40000000,4563029,88069880,48069880,120.17469999999999
693,The Judge,37300000,2014-10-10,50000000,47119388,76119388,26119388,52.238776
694,Muppets Most Wanted,29200000,2014-03-21,55000000,51178893,79312301,24312301,44.20418363636364
695,If I Stay,28400000,2014-08-22,11000000,50474843,78356170,67356170,612.3288181818182
696,"I, Frankenstein",52100000,2014-01-24,65000000,19075290,74575290,9575290,14.731215384615384
697,Think Like a Man Too,5000000,2014-06-20,24000000,65028687,70027933,46027933,191.7830541666667
698,Brick Mansions,48500000,2014-04-25,28000000,20396829,73421224,45421224,162.21865714285715
699,Son of God,8100000,2014-02-28,22000000,59700064,70949793,48949793,222.4990590909091
700,Jersey Boys,20600000,2014-06-20,40000000,47047013,65282732,25282732,63.206830000000004
701,The Giver,21900000,2014-08-15,25000000,45090374,66540205,41540205,166.16082
702,Selma,14700000,2015-01-09,20000000,52076908,66776576,46776576,233.88288
703,Begin Again,47300000,2014-06-27,8000000,16170632,68838736,60838736,760.4842
704,The Legend of Hercules,42400000,2014-01-10,70000000,18848538,58953319,-11046681,-15.780972857142858
705,Dolphin Tale 2,15800000,2014-09-12,36000000,42024533,57824533,21824533,60.62370277777778
706,St. Vincent,10700000,2014-10-10,13000000,44137712,54837234,41837234,321.82487692307694
707,A Walk Among the Tombstones,26900000,2014-09-19,28000000,26017685,62108587,34108587,121.81638214285715
708,3 Days to Kill,21900000,2014-02-21,28000000,30697999,38959900,10959900,39.142500000000005
709,Whiplash,35900000,2014-10-10,3300000,13092006,38969037,35669037,1080.879909090909
710,Earth to Echo,6400000,2014-07-02,13000000,38934842,42174545,29174545,224.41957692307693
711,Boyhood,19100000,2014-07-11,4000000,25379975,57273049,53273049,1331.826225
712,Oculus,16300000,2014-04-11,5000000,27695246,44115496,39115496,782.3099199999999
713,This is Where I Leave You,7000000,2014-09-19,20000000,34296320,41296320,21296320,106.4816
714,That Awkward Moment,14400000,2014-01-31,8000000,26068955,53068955,45068955,563.3619375000001
715,The Gambler,5600000,2014-12-10,25000000,33680992,38718031,13718031,54.872124
717,Million Dollar Arm,2800000,2014-05-16,25000000,36447959,39217912,14217912,56.87164799999999
718,Nightcrawler,6300000,2014-10-31,8500000,32381218,50334418,41834418,492.16962352941175
719,Devil's Due,21100000,2014-01-17,7000000,15821461,36146087,29146087,416.37267142857144
720,A Most Wanted Man,19000000,2014-07-25,15000000,17237855,36068890,21068890,140.45926666666665
721,The Best of Me,9200000,2014-10-17,26000000,26766213,41059418,15059418,57.92083846153846
722,The November Man,7500000,2014-08-27,15000000,25018119,34820335,19820335,132.13556666666665
723,When the Game Stands Tall,0,2014-08-22,15000000,30127963,30138912,15138912,100.92608000000001
724,Draft Day,620000,2014-04-11,25000000,28842237,29847480,4847480,19.38992
725,Big Eyes,14800000,2014-12-25,10000000,14482031,27317872,17317872,173.17872
726,Top Five,800000,2014-12-12,12000000,25317379,26001741,14001741,116.681175
727,And So It Goes,10200000,2014-07-25,18000000,15160801,17920013,-79987,-0.4443722222222222
728,A Haunted House 2,6600000,2014-04-18,4000000,17329487,21206861,17206861,430.171525
729,The Railway Man,17900000,2014-04-11,18000000,4438438,23910210,5910210,32.8345
730,Mr. Turner,18200000,2014-12-19,14000000,3958546,25187026,11187026,79.90732857142856
731,Labor Day,6900000,2014-01-31,18000000,13371528,14189810,-3810190,-21.16772222222222
732,The Drop,7900000,2014-09-12,12600000,10724389,19054534,6454534,51.22646031746032
733,Addicted,0,2014-10-10,5000000,17390770,17499242,12499242,249.98484
734,Inherent Vice,6600000,2014-12-12,20000000,8110975,14772346,-5227654,-26.138270000000002
735,A Most Violent Year,6300000,2014-12-31,20000000,5749134,8846875,-11153125,-55.765625
736,The Babadook,9300000,2014-11-28,2000000,950792,7482387,5482387,274.11935
737,The Immigrant,3800000,2014-05-16,16000000,2013456,7585011,-8414989,-52.59368125
738,Wish I Was Here,1900000,2014-07-18,6000000,3591299,6591365,591365,9.856083333333334
739,The Skeleton Twins,0,2014-09-12,1000000,5284309,5797192,4797192,479.7192
740,Dear White People,0,2014-10-17,1250000,4404154,5403771,4153771,332.30168
741,The Lunchbox,0,2014-02-28,1700000,4231500,12231500,10531500,619.5
742,Ida,0,2014-05-02,2600000,3827060,15298355,12698355,488.39826923076924
743,Veronica Mars,195000,2014-03-14,6000000,3322127,3485383,-2514617,-41.91028333333333
744,Mommy,0,2015-01-23,4900000,3498695,17536004,12636004,257.87763265306126
745,The Rover,2100000,2014-06-13,8500000,1109199,3180252,-5319748,-62.585270588235296
746,Rosewater,0,2014-11-14,10000000,3128941,3185717,-6814283,-68.14283
747,Obvious Child,0,2014-06-06,1000000,3122616,3324070,2324070,232.40699999999998
748,Kill the Messenger,0,2014-10-10,5000000,2450846,6656705,1656705,33.1341
749,The Homesman,0,2014-11-14,16000000,2429989,8217571,-7782429,-48.64018125
750,Tusk,0,2014-09-19,3000000,1821983,1887554,-1112446,-37.08153333333333
751,Locke,0,2014-04-25,2000000,1370646,2088390,88390,4.4195
752,Jackpot,1100000,2001-07-27,400000,44452,44452,-355548,-88.887
753,Palo Alto,0,2014-05-09,1000000,767732,1156309,156309,15.6309
754,Dom Hemingway,0,2014-04-02,7000000,523511,1857458,-5142542,-73.46488571428571
755,The Face of Love,0,2014-03-07,4000000,385069,1158877,-2841123,-71.028075
756,I Origins,0,2014-07-18,1000000,336472,852399,-147601,-14.760100000000001
757,Rudderless,0,2014-10-17,5000000,56001,567219,-4432781,-88.65562
758,Two Night Stand,0,2014-09-26,1600000,15600,868081,-731919,-45.7449375
759,13 Sins,0,2014-04-18,4000000,9134,47552,-3952448,-98.8112
760,Camp X-Ray,0,2014-10-17,1000000,9837,101053,-898947,-89.8947
761,Wolves,0,2014-11-14,18000000,0,94953,-17905047,-99.47248333333333
762,Falcon Rising,0,2014-09-04,4500000,11774,11774,-4488226,-99.73835555555556
763,Anna,0,2014-06-06,4357373,0,1200000,-3157373,-72.46047102233388
764,Jurassic World,10190000,2015-06-12,215000000,652270625,1648854864,1433854864,666.9092390697674
765,Furious 7,1163,2015-04-03,190000000,353007020,1518722794,1328722794,699.3277863157895
766,Avengers: Age of Ultron,946400000,2015-05-01,330600000,459005868,1403013963,1072413963,324.38413883847545
767,Minions,823400000,2015-07-10,74000000,336045770,1160336173,1086336173,1468.0218554054054
768,Spectre,680600000,2015-11-06,300000000,200074175,879620923,579620923,193.20697433333333
769,Inside Out,501100000,2015-06-19,175000000,356461711,854235992,679235992,388.1348525714286
770,The Hunger Games: Mockingjay - Part 2,371700000,2015-11-20,160000000,281723902,648986787,488986787,305.616741875
771,The Martian,401700000,2015-10-02,108000000,228433663,655271443,547271443,506.7328175925926
772,Fifty Shades of Grey,404800000,2015-02-13,40000000,166167230,570998101,530998101,1327.4952524999999
773,The Revenant,349300000,2015-12-25,135000000,183637894,532938302,397938302,294.7691125925926
774,Ant-Man,339100000,2015-07-17,130000000,180202163,518858449,388858449,299.1218838461538
775,Hotel Transylvania 2,305100000,2015-09-25,80000000,169700110,469500298,389500298,486.8753725
776,San Andreas,318800000,2015-05-29,110000000,155190832,456258539,346258539,314.78049
777,Terminator: Genisys,350800000,2015-07-01,155000000,89760956,432150894,277150894,178.80702838709678
778,Kingsman: The Secret Service,286100000,2015-02-13,94000000,128261724,404561724,310561724,330.38481276595746
779,Mad Max: Fury Road,224800000,2015-05-15,150000000,153636354,370098020,220098020,146.73201333333336
780,The Good Dinosaur,209100000,2015-11-25,187500000,123087120,333771037,146271037,78.01121973333333
781,Taken 3,237200000,2015-01-09,48000000,89256424,327656424,279656424,582.6175499999999
782,The SpongeBob Movie: Sponge Out of Water,162200000,2015-02-06,74000000,162994032,311013181,237013181,320.2880824324324
783,Maze Runner: The Scorch Trials,230600000,2015-09-18,61000000,81697192,310566162,249566162,409.12485573770493
784,The Divergent Series: Insurgent,167100000,2015-03-20,110000000,130179072,295075882,185075882,168.25080181818183
785,Pitch Perfect 2,103200000,2015-05-15,29000000,184296230,287625468,258625468,891.8119586206897
786,Paddington,191800000,2015-01-16,55000000,76223578,258789097,203789097,370.5256309090909
787,The Peanuts Movie,116100000,2015-11-06,99000000,130178411,250091610,151091610,152.61778787878788
788,Pixels,166100000,2015-07-24,90000000,78765986,244041804,154041804,171.15756
789,Alvin and the Chipmunks: The Road Chip,148900000,2015-12-18,90000000,85886987,249517956,159517956,177.24217333333334
790,Ted 2,135200000,2015-06-26,68000000,81476385,217214143,149214143,219.4325632352941
791,Tomorrowland,115700000,2015-05-22,170000000,93436322,206627518,36627518,21.54559882352941
792,Straight Outta Compton,40400000,2015-08-14,28000000,161197785,202182981,174182981,622.0820749999999
793,The Intern,118800000,2015-09-25,40000000,75764672,197115710,157115710,392.789275
794,Jupiter Ascending,136600000,2015-02-06,179000000,47482519,181982519,2982519,1.6662117318435754
795,Creed,63800000,2015-11-25,37000000,109767581,173567581,136567581,369.10157027027026
796,Fantastic Four,111900000,2015-08-07,120000000,56117548,167849187,47849187,39.8743225
798,Bridge of Spies,93200000,2015-10-16,40000000,72313754,162498338,122498338,306.245845
799,The Hateful Eight,101600000,2015-12-25,62000000,54117416,147864886,85864886,138.49175161290324
800,Goosebumps,70100000,2015-10-16,58000000,80069458,158905324,100905324,173.97469655172412
801,The Last Witch Hunter,119600000,2015-10-23,80000000,27367660,130818912,50818912,63.52364
802,Trainwreck,30600000,2015-07-17,35000000,110212700,141123897,106123897,303.21113428571425
803,The Big Short,63200000,2015-12-11,28000000,70259870,133162752,105162752,375.5812571428571
804,Pan,93300000,2015-10-09,150000000,35088320,151525973,1525973,1.0173153333333333
805,Magic Mike XXL,56500000,2015-07-01,14500000,66013057,123660597,109160597,752.8317034482758
806,Seventh Son,97000000,2015-02-06,95000000,17725785,108874967,13874967,14.605228421052633
807,Insidious Chapter 3,60800000,2015-06-05,10000000,52218558,120453155,110453155,1104.53155
808,Get Hard,21400000,2015-03-27,40000000,90411453,106511453,66511453,166.2786325
809,The Man From U.N.C.L.E.,64400000,2015-08-14,75000000,45445109,104949584,29949584,39.93277866666667
810,Paul Blart: Mall Cop 2,36600000,2015-04-17,38000000,71091594,107650646,69650646,183.29117368421052
811,Sisters,18000000,2015-12-18,30000000,87044645,106030660,76030660,253.43553333333335
812,Vacation,46000000,2015-07-29,31000000,58884188,102306500,71306500,230.0209677419355
813,Chappie,70500000,2015-03-06,49000000,31569268,105002056,56002056,114.28991020408164
814,Joy,44700000,2015-12-25,60000000,56451232,101134059,41134059,68.556765
815,Black Mass,37200000,2015-09-18,53000000,62575678,98837872,45837872,86.48655094339622
816,The Visit,33200000,2015-09-11,5000000,65206105,98677816,93677816,1873.5563200000001
817,Spotlight,53200000,2015-11-06,20000000,45055776,92088460,72088460,360.4423
818,In the Heart of the Sea,68900000,2015-12-11,100000000,25020758,89693309,-10306691,-10.306690999999999
819,Southpaw,39500000,2015-07-24,30000000,52421953,94156456,64156456,213.85485333333332
820,The Second Best Exotic Marigold Hotel,52900000,2015-03-06,10000000,33078266,90384306,80384306,803.84306
821,Paper Towns,53500000,2015-07-24,12000000,32000304,85450484,73450484,612.0873666666666
822,Sicario,38000000,2015-09-18,30000000,46889293,84393749,54393749,181.31249666666668
823,Hitman: Agent 47,59900000,2015-08-21,35000000,22467450,82182803,47182803,134.80800857142856
824,The Wedding Ringer,15300000,2015-01-16,23000000,64460211,80171596,57171596,248.57215652173915
825,Paranormal Activity: The Ghost Dimension,60600000,2015-10-23,10000000,18297124,77959374,67959374,679.59374
826,Crimson Peak,43600000,2015-10-16,55000000,31090320,74966854,19966854,36.30337090909091
827,The Transporter Refueled,56600000,2015-09-04,22000000,16029670,69698495,47698495,216.81134090909092
828,Run All Night,45200000,2015-03-13,50000000,26461644,66961644,16961644,33.923288
829,War Room,0,2015-08-28,3000000,67790117,73975239,70975239,2365.8413
830,The Age of Adaline,23000000,2015-04-24,30000000,42629776,68984536,38984536,129.94845333333333
831,Unfriended,31600000,2015-04-17,1000000,32789645,64364198,63364198,6336.419800000001
832,The Longest Ride,25500000,2015-04-10,34000000,37446117,63802928,29802928,87.6556705882353
833,Brooklyn,23800000,2015-11-04,11000000,38322743,62076141,51076141,464.3285545454545
834,Woman in Gold,28300000,2015-04-01,11000000,33307793,58586407,47586407,432.60370000000006
835,Krampus,18800000,2015-12-04,15000000,42725475,61788393,46788393,311.92262
836,The Walk,51000000,2015-09-30,35000000,10161183,61492104,26492104,75.69172571428572
837,The Perfect Guy,3200000,2015-09-11,18000000,57027435,60278166,42278166,234.8787
838,No Escape,27100000,2015-08-26,5000000,27288872,42844516,37844516,756.89032
839,Sinister 2,25100000,2015-08-21,10000000,27740955,54104225,44104225,441.04225
840,The Boy Next Door,17000000,2015-01-23,4000000,36006065,53401938,49401938,1235.04845
841,The Night Before,9300000,2015-11-20,25000000,43035725,52427346,27427346,109.70938400000001
842,Hot Pursuit,17100000,2015-05-08,35000000,34580201,45671512,10671512,30.490034285714284
843,Entourage,16900000,2015-06-03,30000000,32363404,46438538,16438538,54.79512666666667
844,Mortdecai,39600000,2015-01-23,60000000,7696134,30396134,-29603866,-49.339776666666666
845,"McFarland, USA",1200000,2015-02-20,17000000,44480275,45707924,28707924,168.87014117647058
846,Still Alice,25100000,2015-01-16,5000000,18656400,41699612,36699612,733.99224
847,The DUFF,9500000,2015-02-20,8500000,34030343,43528634,35028634,412.10157647058827
848,Legend,41100000,1986-04-18,25000000,15502112,23506237,-1493763,-5.975052
850,The Gallows,20200000,2015-07-10,100000,22764410,41656474,41556474,41556.473999999995
851,Love the Coopers,16100000,2015-11-13,18000000,26302731,42227490,24227490,134.59716666666665
852,The Lady in the Van,31400000,2016-01-15,6000000,10021175,42320503,36320503,605.3417166666667
853,Ricki and the Flash,14500000,2015-08-07,18000000,26839498,41166033,23166033,128.70018333333334
854,Carol,27600000,2015-11-20,11800000,12711491,42843521,31043521,263.080686440678
855,The Lazarus Effect,12600000,2015-02-27,5000000,25801570,38359310,33359310,667.1862
856,The Water Diviner,34000000,2015-04-24,22500000,4200117,31054727,8554727,38.02100888888889
857,A Walk in the Woods,8000000,2015-09-02,8000000,29499394,37119358,29119358,363.99197499999997
858,Ex Machina,11400000,2015-04-10,13000000,25440971,38358392,25358392,195.06455384615384
859,Burnt,23000000,2015-10-30,20000000,13651946,36773510,16773510,83.86755000000001
860,Room,20700000,2015-10-16,13000000,14677674,36262783,23262783,178.94448461538462
861,Steve Jobs,16700000,2015-10-09,30000000,17766658,35579007,5579007,18.59669
862,Victor Frankenstein,28500000,2015-11-25,40000000,5775076,31124367,-8875633,-22.1890825
863,Project Almanac,10900000,2015-01-30,12000000,22348241,32909437,20909437,174.24530833333333
864,Self/Less,18200000,2015-07-10,26000000,12279691,33667319,7667319,29.48968846153846
865,American Ultra,12700000,2015-08-21,28000000,14439985,30295028,2295028,8.196528571428571
866,Aloha,5200000,2015-05-29,37000000,21052030,25387091,-11612909,-31.386240540540538
867,The 33,12700000,2015-11-13,25000000,12227722,28400715,3400715,13.60286
868,The Gunman,13500000,2015-03-20,40000000,10664749,18594227,-21405773,-53.5144325
869,Black or White,0,2015-01-30,9000000,21571189,21971021,12971021,144.12245555555558
870,Blackhat,11600000,2015-01-16,70000000,8005980,19665004,-50334996,-71.90713714285715
871,Dope,480000,2015-06-19,7000000,17506470,18190831,11190831,159.8690142857143
872,While We're Young,9700000,2015-03-27,10000000,7582065,17503828,7503828,75.03828
873,Scouts Guide to the Zombie Apocalypse,12400000,2015-10-30,15000000,3703046,15554855,554855,3.6990333333333334
874,Suffragette,11300000,2015-10-23,14000000,4702420,34044909,20044909,143.1779214285714
875,It Follows,0,2015-03-13,2000000,14674077,23250755,21250755,1062.5377500000002
876,Unfinished Business,4200000,2015-03-06,35000000,10219501,13214051,-21785949,-62.245568571428564
877,Do You Believe?,1400000,2015-03-20,2300000,12985600,14304931,12004931,521.9535217391305
878,Woodlawn,0,2015-10-16,13000000,14394097,14403703,1403703,10.797715384615385
879,Hot Tub Time Machine 2,767000,2015-02-20,14000000,12314651,12826644,-1173356,-8.381114285714286
880,Child 44,11700000,2015-04-17,50000000,1224330,8004221,-41995779,-83.991558
881,We Are Your Friends,7500000,2015-08-28,2000000,3591417,10153415,8153415,407.67075000000006
882,Danny Collins,5200000,2015-03-20,10000000,5637066,8465845,-1534155,-15.341550000000002
883,Shanghai,9200000,2015-10-02,50000000,46425,15505922,-34494078,-68.988156
884,Me and Earl and the Dying Girl,2300000,2015-06-12,8000000,6758416,9266180,1266180,15.827250000000001
885,Bajrangi Bhaijaan,0,2015-07-17,13000000,8178001,121778347,108778347,836.7565153846155
886,The Green Inferno,0,2015-09-25,1000000,7192291,12931420,11931420,1193.1419999999998
887,Baahubali: The Beginning,0,2015-07-10,40000000,6738000,26736665,-13263335,-33.1583375
888,Little Boy,0,2015-04-24,20000000,6485961,17769299,-2230701,-11.153505
889,Anomalisa,1900000,2015-12-30,8000000,3759286,5706168,-2293832,-28.672900000000002
890,Trash,4800000,2015-10-09,12000000,17484,6553186,-5446814,-45.39011666666667
891,Escobar: Paradise Lost,3600000,2015-06-26,17000000,195792,3917679,-13082321,-76.9548294117647
892,By the Sea,2800000,2015-11-13,20000000,538460,3727746,-16272254,-81.36126999999999
893,Youth,0,2015-12-04,13000000,2703296,24001573,11001573,84.62748461538462
894,Jem and the Holograms,149000,2015-10-23,5000000,2184640,2368937,-2631063,-52.62126000000001
895,Testament of Youth,0,2015-06-05,10000000,1822250,6646669,-3353331,-33.53331
896,The Vatican Tapes,0,2015-07-24,13000000,1784763,14929184,1929184,14.839876923076922
897,The Diary of a Teenage Girl,0,2015-08-07,2000000,1477002,2279959,279959,13.997950000000001
898,Mustang,0,2015-11-20,1400000,845464,5552584,4152584,296.61314285714286
899,The D Train,102000,2015-05-08,3000000,669688,772366,-2227634,-74.25446666666666
900,Freeheld,0,2015-10-02,7000000,546201,1732228,-5267772,-75.25388571428572
901,Maggie,0,2015-05-08,4500000,187112,1027760,-3472240,-77.16088888888889
902,Desert Dancer,0,2015-04-10,4000000,155271,596335,-3403665,-85.09162500000001
903,Manglehorn,0,2015-06-19,4000000,132270,797439,-3202561,-80.064025
904,Eden,0,2016-01-19,2300000,0,0,-2300000,-100.0
905,Before We Go,0,2015-09-04,3000000,37151,483938,-2516062,-83.86873333333334
906,Knock Knock,0,2015-10-09,2000000,36336,6328516,4328516,216.42579999999998
907,Song One,0,2015-01-23,6000000,32251,437089,-5562911,-92.71518333333333
908,Strangerland,0,2015-07-10,10000000,17472,161097,-9838903,-98.38903
909,Skin Trade,0,2015-05-08,9000000,1242,1242,-8998758,-99.9862
910,Captain America: Civil War,745200000,2016-05-06,250000000,408084349,1140069413,890069413,356.0277652
911,Rogue One: A Star Wars Story,523900000,2016-12-16,200000000,532177324,1049102856,849102856,424.551428
912,Finding Dory,542300000,2016-06-17,200000000,486295561,1021215193,821215193,410.60759649999994
913,Zootopia,682500000,2016-03-04,150000000,341268248,1019429616,869429616,579.6197440000001
914,The Secret Life of Pets,507100000,2016-07-08,75000000,368384330,886750534,811750534,1082.3340453333333
915,Batman v Superman: Dawn of Justice,543300000,2016-03-25,250000000,330360194,867500281,617500281,247.0001124
916,Deadpool,420000000,2016-02-12,58000000,363070709,801025593,743025593,1281.0786086206897
917,Suicide Squad,421700000,2016-08-05,175000000,325100054,746059887,571059887,326.31993542857145
918,Doctor Strange,445100000,2016-11-04,165000000,232641920,676404566,511404566,309.94216121212116
919,Moana,394600000,2016-11-23,150000000,248757044,637517365,487517365,325.01157666666666
920,Sing,363800000,2016-12-21,75000000,270329045,634454789,559454789,745.9397186666667
921,X-Men: Apocalypse,388500000,2016-05-27,178000000,155442489,542537546,364537546,204.79637415730338
922,Kung Fu Panda 3,377600000,2016-01-29,140000000,143528619,517599142,377599142,269.71367285714285
923,La La Land,295000000,2016-12-09,20000000,151101803,426351163,406351163,2031.755815
924,Warcraft,386300000,2016-06-10,160000000,47225655,425522281,265522281,165.951425625
925,Jason Bourne,253100000,2016-07-29,120000000,162192920,416168316,296168316,246.80692999999997
926,Ice Age: Collision Course,344500000,2016-07-22,105000000,64063008,402156682,297156682,283.0063638095238
927,Independence Day: Resurgence,286500000,2016-06-24,165000000,103144286,384169424,219169424,132.82995393939393
928,The Legend of Tarzan,230100000,2016-07-01,180000000,126643061,348902025,168902025,93.83445833333333
929,The Angry Birds Movie,244800000,2016-05-20,73000000,107509366,352327887,279327887,382.6409410958904
930,Trolls,193200000,2016-11-04,125000000,153707064,344150134,219150134,175.3201072
931,Star Trek Beyond,184600000,2016-07-22,185000000,158848340,335802233,150802233,81.51472054054054
932,Now You See Me 2,269800000,2016-06-10,90000000,65075540,328325007,238325007,264.80556333333334
933,Dangal,290500000,2016-12-21,9500000,12391761,294654618,285154618,3001.627557894737
934,Alice Through the Looking Glass,222400000,2016-05-27,170000000,77042381,276928112,106928112,62.8988894117647
935,Teenage Mutant Ninja Turtles: Out of the Shadows,163600000,2016-06-03,135000000,82051601,245328374,110328374,81.72472148148148
936,Sully,115700000,2016-09-09,60000000,125070033,238524556,178524556,297.5409266666667
937,Hidden Figures,66300000,2016-12-25,25000000,169607287,231771716,206771716,827.086864
938,Inferno,185700000,2016-10-28,75000000,34343574,219519367,144519367,192.69248933333333
939,Central Intelligence,89500000,2016-06-17,50000000,127440871,217194805,167194805,334.38961
940,Me Before You,152100000,2016-06-03,20000000,56245075,208265198,188265198,941.32599
941,London Has Fallen,143200000,2016-03-04,60000000,62524260,195194085,135194085,225.32347499999997
942,Arrival,102800000,2016-11-11,47000000,100546139,203127894,156127894,332.1870085106383
943,Bad Moms,70700000,2016-07-29,20000000,113257297,180998716,160998716,804.9935800000001
944,Storks,110700000,2016-09-23,70000000,72679278,183353431,113353431,161.93347285714285
945,The BFG,127900000,2016-07-01,140000000,55483770,199646680,59646680,42.60477142857143
946,The Divergent Series: Allegiant,113100000,2016-03-18,110000000,66184051,172022517,62022517,56.38410636363636
947,Hacksaw Ridge,108100000,2016-11-04,40000000,67209615,168904682,128904682,322.261705
948,Jack Reacher: Never Go Back,103400000,2016-10-21,60000000,58697076,159946489,99946489,166.57748166666667
949,The Accountant,68900000,2016-10-14,40000000,86260045,152962083,112962083,282.4052075
950,Gods of Egypt,119500000,2016-02-26,140000000,31153464,138836756,-1163244,-0.8308885714285714
951,Lights Out,81600000,2016-07-22,5000000,67268835,148806510,143806510,2876.1302
952,Sausage Party,43000000,2016-08-12,19000000,97670358,141344255,122344255,643.9171315789474
953,Lion,88600000,2016-11-25,12000000,51739495,149570720,137570720,1146.4226666666666
954,Mechanic: Resurrection,104500000,2016-08-26,40000000,21218403,109738840,69738840,174.3471
955,Ride Along 2,33400000,2016-01-15,40000000,90862685,124827316,84827316,212.06829
956,Deepwater Horizon,60400000,2016-09-30,156000000,61433527,122603824,-33396176,-21.40780512820513
957,Allied,79400000,2016-11-23,106000000,40098064,119266661,13266661,12.515717924528303
958,The Shallows,64000000,2016-06-24,13000000,55121623,118763442,105763442,813.5649384615384
959,The Purge: Election Year,39400000,2016-07-01,10000000,79042440,118514727,108514727,1085.14727
960,Why Him?,57800000,2016-12-23,38000000,60323786,117425156,79425156,209.01356842105264
961,Office Christmas Party,59700000,2016-12-09,45000000,54767494,91323299,46323299,102.94066444444445
962,10 Cloverfield Lane,38100000,2016-03-11,5000000,72082999,108286422,103286422,2065.7284400000003
963,The 5th Wave,75000000,2016-01-22,38000000,34912982,111336398,73336398,192.99052105263158
964,Neighbors 2: Sorority Rising,52600000,2016-05-20,35000000,55340730,108757621,73757621,210.73605999999998
965,The Little Prince,96200000,2016-02-12,77500000,1311213,102028919,24528919,31.650218064516128
966,Dirty Grandpa,58500000,2016-01-22,11500000,35593113,105078449,93578449,813.7256434782608
967,Money Monster,52300000,2016-05-13,27000000,41012075,93466095,66466095,246.1707222222222
968,My Big Fat Greek Wedding 2,29200000,2016-03-25,18000000,59689605,92096558,74096558,411.6475444444444
969,Collateral Beauty,57500000,2016-12-16,36000000,31016021,85309093,49309093,136.96970277777777
970,Sultan,81100000,2016-07-06,11000000,5599781,72989781,61989781,563.5434636363636
971,War Dogs,43200000,2016-08-19,50000000,43034523,86234503,36234503,72.46900600000001
972,Nerve,46700000,2016-07-27,20000000,38583626,70652284,50652284,253.26142
973,Ouija: Origin of Evil,46600000,2016-10-21,9000000,35144505,81831866,72831866,809.2429555555557
974,Manchester by the Sea,31300000,2016-11-18,8500000,47695371,77733867,69233867,814.5160823529412
975,The Boss,15600000,2016-04-08,29000000,63077560,78652207,49652207,171.21450689655174
976,Mike and Dave Need Wedding Dates,31100000,2016-07-08,33000000,46009673,75898100,42898100,129.99424242424243
977,Miracles from Heaven,12200000,2016-03-16,13000000,61705123,73798736,60798736,467.68258461538466
978,Kubo and the Two Strings,21900000,2016-08-19,55000000,48023088,77548122,22548122,40.99658545454545
979,13 Hours: The Secret Soldiers of Benghazi,16600000,2016-01-15,50000000,52853219,69411370,19411370,38.82274
980,Fences,6700000,2016-12-16,24000000,57682904,64282881,40282881,167.8453375
981,"Hail, Caesar!",33100000,2016-02-05,22000000,30080225,64160680,42160680,191.63945454545456
982,The Nice Guys,26500000,2016-05-20,50000000,36261763,59596747,9596747,19.193494
983,Zoolander 2,27900000,2016-02-12,50000000,28848693,55348693,5348693,10.697386
984,Barbershop: The Next Cut,1000000,2016-04-15,20000000,54030051,54404202,34404202,172.02101000000002
985,The Finest Hours,24500000,2016-01-29,70000000,27569558,49252761,-20747239,-29.638912857142856
986,Patriots Day,18700000,2016-12-21,40000000,31886361,52837989,12837989,32.094972500000004
987,Florence Foster Jenkins,21500000,2016-08-12,29000000,27383770,56000339,27000339,93.1046172413793
988,A Monster Calls,43600000,2017-01-06,43000000,3740823,46414530,3414530,7.940767441860465
989,Eddie the Eagle,30400000,2016-02-26,23000000,15789389,45060480,22060480,95.91513043478261
990,Risen,9200000,2016-02-19,20000000,36880033,46255763,26255763,131.278815
991,Blair Witch,24400000,2016-09-16,10000000,20777061,38985577,28985577,289.85577
992,Almost Christmas,422000,2016-11-11,17000000,42065185,42493506,25493506,149.96179999999998
993,The Witch,15300000,2016-02-19,3500000,25138705,40454520,36954520,1055.8434285714286
994,Hell or High Water,10900000,2016-08-12,12000000,27007844,37584304,25584304,213.20253333333335
995,The Forest,11000000,2016-01-08,10000000,26594261,40749230,30749230,307.4923
996,Snowden,15700000,2016-09-16,50000000,21587519,35380918,-14619082,-29.238164
997,When the Bough Breaks,911000,2016-09-09,10000000,29747603,30768449,20768449,207.68449
998,Nocturnal Animals,19600000,2016-11-18,22500000,10663357,32398681,9898681,43.99413777777777
999,The Light Between Oceans,13400000,2016-09-02,20000000,12545979,22281732,2281732,11.40866
1000,The Brothers Grimsby,18300000,2016-03-11,35000000,6864016,28720470,-6279530,-17.941514285714284
1001,Free State of Jones,4200000,2016-06-24,50000000,20810036,23237252,-26762748,-53.525496
1002,Middle School: The Worst Years of My Life,3300000,2016-10-07,8500000,20007149,23311293,14811293,174.25050588235294
1003,Triple 9,10500000,2016-02-26,20000000,12639297,25943792,5943792,29.71896
1004,Whiskey Tango Foxtrot,0,2016-03-04,35000000,23083334,25350747,-9649253,-27.569294285714285
1005,Fifty Shades of Black,10500000,2016-01-29,5000000,11686940,22113075,17113075,342.2615
1006,Keanu,0,2016-04-29,15000000,20591853,20688141,5688141,37.920939999999995
1007,The Edge of Seventeen,4400000,2016-11-18,9000000,14431633,19096003,10096003,112.17781111111111
1008,Eye in the Sky,0,2016-03-11,13000000,18704596,35402802,22402802,172.32924615384616
1009,Regression,17600000,2015-10-30,20000000,55039,15824374,-4175626,-20.87813
1010,Norm of the North,0,2016-01-15,18000000,17062499,30535660,12535660,69.64255555555555
1011,Hardcore Henry,7600000,2016-04-08,2000000,9252038,17187434,15187434,759.3717
1012,Pride and Prejudice and Zombies,5500000,2016-02-05,28000000,10907291,16638300,-11361700,-40.5775
1013,The Infiltrator,0,2016-07-13,47500000,15436808,20718104,-26781896,-56.38293894736842
1014,"Hello, My Name is Doris",0,2016-03-11,1000000,14444999,14662703,13662703,1366.2703000000001
1015,The Other Side of the Door,11300000,2016-03-04,5000000,3000342,12905107,7905107,158.10214
1016,Jackie,0,2016-12-02,9000000,13960394,36588512,27588512,306.53902222222223
1017,Shut In,6200000,2016-11-11,10000000,6900335,11360665,1360665,13.60665
1018,Loving,5200000,2016-11-04,9000000,7710234,12898064,3898064,43.311822222222226
1019,The Man Who Knew Infinity,8400000,2016-04-29,10000000,3877922,12382122,2382122,23.82122
1020,The Darkness,0,2016-05-13,4000000,10753574,10898293,6898293,172.457325
1021,The Perfect Match,745000,2016-03-11,5000000,9669521,10182050,5182050,103.641
1022,Queen of Katwe,1500000,2016-09-23,15000000,8874389,10055481,-4944519,-32.96346
1023,Miss Sloane,5600000,2016-11-25,18000000,3500605,7719630,-10280370,-57.11316666666667
1024,Morgan,4900000,2016-09-02,8000000,3915251,7298786,-701214,-8.765175
1025,The Young Messiah,0,2016-03-11,16800000,6469813,7313697,-9486303,-56.46608928571428
1026,Incarnate,1500000,2016-12-02,5000000,4799774,9371036,4371036,87.42072
1027,Max Steel,2500000,2016-10-14,10000000,3818664,4563080,-5436920,-54.36919999999999
1028,Midnight Special,2500000,2016-03-18,18000000,3712282,7680250,-10319750,-57.331944444444446
1029,Genius,4300000,2016-06-10,17000000,1361045,7265283,-9734717,-57.26304117647059
1030,Hunt for the Wilderpeople,0,2016-06-24,2500000,5205471,23845533,21345533,853.8213199999999
1031,Bleed for This,0,2016-11-18,16000000,5083906,6603926,-9396074,-58.725462500000006
1032,Hands of Stone,0,2016-08-26,20000000,4712792,5031975,-14968025,-74.840125
1033,The Meddler,0,2016-04-22,3200000,4267219,5526942,2326942,72.7169375
1034,A Hologram for the King,0,2016-04-22,35000000,4212494,11846010,-23153990,-66.15425714285715
1035,Swiss Army Man,0,2016-06-24,3000000,4210454,5837111,2837111,94.57036666666667
1036,Denial,0,2016-09-30,10000000,4073448,9263940,-736060,-7.360600000000001
1037,Green Room,0,2016-04-15,5000000,3220371,3807503,-1192497,-23.84994
1038,Compadres,0,2016-04-22,3000000,3127773,7445044,4445044,148.16813333333334
1039,The Disappointments Room,0,2016-09-09,15000000,2423467,3503761,-11496239,-76.64159333333333
1040,Paterson,0,2016-12-28,5000000,2141423,10727536,5727536,114.55072
1041,The Dressmaker,0,2016-09-23,11900000,2022115,24041617,12141617,102.03039495798319
1042,American Honey,1200000,2016-09-30,3500000,663247,2611750,-888250,-25.378571428571426
1043,Jane Got a Gun,0,2016-01-29,25000000,1513793,3771345,-21228655,-84.91462
1044,The Neon Demon,0,2016-06-24,7500000,1333124,3559803,-3940197,-52.53596
1045,Operation Chromite,0,2016-08-05,12700000,1022720,49196532,36496532,287.3742677165354
1046,Dheepan,0,2016-05-06,9000000,248795,7704357,-1295643,-14.396033333333333
1047,The Invitation,0,2016-04-08,1000000,231738,354836,-645164,-64.51639999999999
1048,A Street Cat Named Bob,0,2016-11-18,8000000,82703,17382693,9382693,117.28366249999999
1049,Evolution,0,2001-06-08,80000000,38311134,98341932,18341932,22.927415
1050,They Will Have to Kill Us First,0,2016-03-04,600000,0,7943,-592057,-98.67616666666666
1051,The Fate of the Furious,1010,2017-04-14,250000000,225764765,1234846267,984846267,393.9385068
1052,Despicable Me 3,770200000,2017-06-30,75000000,264624300,1034727750,959727750,1279.637
1053,Jumanji: Welcome to the Jungle,557600000,2017-12-20,90000000,404508916,964496193,874496193,971.6624366666666
1054,Spider-Man: Homecoming,546000000,2017-07-07,175000000,334201140,880166350,705166350,402.9522
1055,Thor: Ragnarok,538900000,2017-11-03,180000000,315058289,846980024,666980024,370.5444577777778
1056,Wonder Woman,409300000,2017-06-02,150000000,412563408,821133378,671133378,447.42225199999996
1057,Coco,597400000,2017-11-22,175000000,209726015,798008101,623008101,356.00462914285714
1058,Pirates of the Caribbean: Dead Men Tell No Tales,622300000,2017-05-26,230000000,172558876,788241137,558241137,242.71353782608696
1059,It,372900000,2017-09-08,35000000,327481748,697457969,662457969,1892.7370542857143
1060,Justice League,428900000,2017-11-17,300000000,229024295,655945209,355945209,118.64840299999999
1061,Transformers: The Last Knight,475300000,2017-06-21,217000000,130168683,602893340,385893340,177.8310322580645
1062,Kong: Skull Island,398600000,2017-03-10,185000000,168052812,561072059,376072059,203.28219405405403
1063,The Boss Baby,353000000,2017-03-31,125000000,175003033,510878762,385878762,308.7030096
1064,Dunkirk,337200000,2017-07-21,150000000,190068280,499837368,349837368,233.22491200000002
1065,War for the Planet of the Apes,343800000,2017-07-14,152000000,146880162,489592267,337592267,222.10017565789474
1066,The Greatest Showman,260700000,2017-12-20,84000000,174340174,386665550,302665550,360.31613095238095
1067,Kingsman: The Golden Circle,310700000,2017-09-22,104000000,100234838,408803696,304803696,293.0804769230769
1068,Cars 3,231000000,2017-06-16,175000000,152901115,383541369,208541369,119.16649657142857
1069,Fifty Shades Darker,267000000,2017-02-10,55000000,114434010,381398492,326398492,593.4518036363636
1070,The Great Wall,289400000,2017-02-17,150000000,45157105,334486852,184486852,122.99123466666666
1071,Resident Evil: The Final Chapter,285400000,2017-01-27,40000000,26844692,314101190,274101190,685.252975
1072,Annabelle: Creation,204400000,2017-08-11,15000000,102092201,305384865,290384865,1935.8990999999999
1073,Wonder,173500000,2017-11-17,20000000,132422809,304604712,284604712,1423.02356
1074,Ferdinand,211700000,2017-12-15,111000000,84410380,289847930,178847930,161.12426126126127
1075,Split,140200000,2017-01-20,5000000,138141585,278964806,273964806,5479.29612
1076,Blade Runner 2049,167200000,2017-10-06,185000000,92054159,259357408,74357408,40.19319351351351
1077,Get Out,79400000,2017-02-24,5000000,176040665,255367951,250367951,5007.35902
1078,Baahubali 2: The Conclusion,234000000,2017-04-28,30000000,18985794,263502914,233502914,778.3430466666666
1079,Alien: Covenant,166600000,2017-05-19,97000000,74262031,238521247,141521247,145.89819278350515
1080,Baby Driver,119100000,2017-06-28,34000000,107825862,228104185,194104185,570.8946617647059
1081,Valerian and the City of a Thousand Planets,184700000,2017-07-21,180000000,40479370,215098356,35098356,19.499086666666667
1082,Geostorm,187900000,2017-10-20,100000000,33700160,220796009,120796009,120.796009
1083,The Emoji Movie,131699999,2017-07-28,50000000,86089513,216562312,166562312,333.124624
1084,Smurfs: The Lost Village,152200000,2017-04-07,60000000,45020282,197578586,137578586,229.29764333333333
1085,The Shape of Water,131400000,2017-12-01,19500000,63859435,195790794,176290794,904.0553538461538
1086,Pitch Perfect 3,80500000,2017-12-22,45000000,104897530,185736412,140736412,312.7475822222222
1087,The Post,97900000,2017-12-22,50000000,81903458,179748880,129748880,259.49775999999997
1088,Baywatch,119800000,2017-05-25,60000000,58060186,175863783,115863783,193.106305
1089,John Wick: Chapter Two,79500000,2017-02-10,40000000,92029184,171350009,131350009,328.3750225
1090,"Three Billboards Outside Ebbing, Missouri",104700000,2017-11-10,12000000,54513740,160191915,148191915,1234.9326250000001
1091,Darkest Hour,94400000,2017-11-22,30000000,56443120,150807172,120807172,402.6905733333333
1092,King Arthur: Legend of the Sword,109500000,2017-05-12,175000000,39175066,139630336,-35369664,-20.21123657142857
1093,The Foreigner,111000000,2017-10-13,35000000,34393507,140783360,105783360,302.23817142857143
1094,Girls Trip,25400000,2017-07-21,28000000,115108515,140886353,112886353,403.1655464285715
1095,American Made,83500000,2017-09-29,50000000,51342000,135569212,85569212,171.138424
1096,A Bad Moms Christmas,58400000,2017-11-01,28000000,72110659,127710550,99710550,356.1091071428571
1097,Captain Underpants: The First Epic Movie,51600000,2017-06-02,38000000,73921000,126577874,88577874,233.09966842105263
1098,Happy Death Day,69800000,2017-10-13,5000000,55683845,125010260,120010260,2400.2052
1099,The Dark Tower,62500000,2017-08-04,60000000,50701325,113461527,53461527,89.102545
1100,Jigsaw,64900000,2017-10-27,10000000,38052832,102445196,92445196,924.45196
1101,Atomic Blonde,48300000,2017-07-28,30000000,51573925,98345423,68345423,227.81807666666666
1102,Rings,55300000,2017-02-03,25000000,27793018,82917283,57917283,231.669132
1103,Underworld: Blood Wars,50700000,2017-01-06,35000000,30353973,81209222,46209222,132.02634857142857
1104,Lady Bird,30000000,2017-11-03,10000000,48958273,78610769,68610769,686.1076899999999
1105,American Assassin,31000000,2017-09-15,63000000,36249674,68310140,5310140,8.42879365079365
1106,Victoria and Abdul,43200000,2017-09-22,21000000,22245070,68271146,47271146,225.10069523809523
1107,The Nut Job 2: Nutty by Nature,36800000,2017-08-11,40000000,28370522,57438389,17438389,43.5959725
1108,Monster Trucks,31100000,2017-01-13,125000000,33370166,61642798,-63357202,-50.6857616
1109,The Star,22000000,2017-11-17,20000000,40847995,62758010,42758010,213.79005
1110,"Everything, Everything",27500000,2017-05-19,10000000,34121140,61603136,51603136,516.0313600000001
1111,Snatched,15000000,2017-05-12,42000000,45852178,57852177,15852177,37.743278571428576
1112,The Big Sick,13500000,2017-06-23,5000000,42872467,53972860,48972860,979.4572000000001
1113,Downsizing,30600000,2017-12-22,68000000,24449754,54462971,-13537029,-19.907395588235293
1114,"I, Tonya",23900000,2017-12-08,11000000,30014534,53797409,42797409,389.0673545454546
1115,Logan Lucky,20700000,2017-08-18,29000000,27778642,44264271,15264271,52.635417241379315
1116,Rough Night,25200000,2017-06-16,20000000,22105643,46844357,26844357,134.22178499999998
1117,All Eyez on Me,0,2017-06-16,45000000,44922302,54876855,9876855,21.948566666666665
1118,mother!,26700000,2017-09-15,30000000,17800004,42531076,12531076,41.770253333333336
1119,The Snowman,36400000,2017-10-20,35000000,6670765,43226146,8226146,23.503274285714284
1120,Gifted,18200000,2017-04-07,7000000,24801212,36964656,29964656,428.0665142857143
1121,T2: Trainspotting,39300000,2017-03-17,18000000,2402004,42091262,24091262,133.84034444444444
1122,Fist Fight,8900000,2017-02-17,25000000,32187017,40286416,15286416,61.145664
1123,Diary of a Wimpy Kid: The Long Haul,19400000,2017-05-19,22000000,20738724,35609577,13609577,61.86171363636363
1124,The House,8600000,2017-06-30,40000000,25584504,31192425,-8807575,-22.0189375
1125,The Disaster Artist,8700000,2017-12-01,10000000,21120616,28717667,18717667,187.17667
1126,Home Again,0,2017-09-08,15000000,27020284,37336874,22336874,148.91249333333334
1127,The Bye Bye Man,4300000,2017-01-13,7400000,22395806,31187727,23787727,321.4557702702703
1128,Father Figures,8100000,2017-12-22,25000000,17501244,21038441,-3961559,-15.846236
1129,The Founder,11300000,2017-01-20,15000000,12786053,24403192,9403192,62.68794666666667
1130,The Lost City of Z,10700000,2017-04-14,30000000,8574339,17121823,-12878177,-42.92725666666667
1131,The Space Between Us,6900000,2017-02-03,30000000,7885294,16481405,-13518595,-45.06198333333333
1132,Wish Upon,0,2017-07-14,12000000,14301505,23477345,11477345,95.64454166666667
1133,"Roman J. Israel, Esq.",1100000,2017-11-17,22000000,11962712,12967012,-9032988,-41.059036363636366
1134,Battle of the Sexes,0,2017-09-22,25000000,12638526,18445379,-6554621,-26.218483999999997
1135,Before I Fall,0,2017-03-03,5000000,12241072,18945682,13945682,278.91364
1136,Rock Dog,0,2017-02-24,60000000,9420546,24148488,-35851512,-59.75252
1137,Stronger,4200000,2017-09-22,30000000,4211129,8786752,-21213248,-70.71082666666668
1138,Tulip Fever,5900000,2017-09-01,25000000,2455635,6792768,-18207232,-72.828928
1139,Just Getting Started,1600000,2017-12-08,22000000,6069605,6756412,-15243588,-69.28903636363636
1140,All Saints,140000,2017-08-25,2000000,5802208,5941994,3941994,197.0997
1141,The Florida Project,0,2017-10-06,2000000,5904366,11295324,9295324,464.7662
1142,Table 19,1400000,2017-03-03,5000000,3614896,4620399,-379601,-7.59202
1143,Collide,2500000,2017-02-24,29200000,2280004,5466698,-23733302,-81.27843150684932
1144,The Wall,2700000,2017-05-12,3000000,1803064,4495262,1495262,49.84206666666667
1145,Friend Request,0,2017-09-22,9900000,3759078,11310835,1410835,14.250858585858586
1146,Free Fire,0,2017-04-21,10000000,1799322,3793739,-6206261,-62.06260999999999
1147,A Ghost Story,0,2017-07-07,100000,1594798,2769782,2669782,2669.782
1148,The Square,0,2010-04-09,1900000,406216,740932,-1159068,-61.00357894736842
1150,Patti Cake$,682000,2017-08-18,1000000,800148,1471090,471090,47.109
1151,Churchill,0,2017-06-02,10000000,1279681,7582196,-2417804,-24.17804
1152,City of Ghosts,100000,2003-04-25,17500000,325491,325491,-17174509,-98.14005142857143
1153,The Journey,0,2003-07-11,500000,19800,19800,-480200,-96.04
1154,Avengers: Infinity War,136900000,2018-04-27,300000000,678815482,2048134200,1748134200,582.7114
1155,Black Panther,646900000,2018-02-16,200000000,700059566,1348258224,1148258224,574.129112
1156,Jurassic World: Fallen Kingdom,891800000,2018-06-22,170000000,417719760,1305772799,1135772799,668.1016464705882
1157,Incredibles 2,634200000,2018-06-15,200000000,608581744,1242520711,1042520711,521.2603555000001
1158,Aquaman,812700000,2018-12-21,160000000,335061807,1146894640,986894640,616.80915
1159,Bohemian Rhapsody,687200000,2018-11-02,55000000,216303339,894985342,839985342,1527.2460763636363
1160,Deadpool 2,460500000,2018-05-18,110000000,324591735,786680557,676680557,615.1641427272727
1161,Fantastic Beasts: The Crimes of Grindelwald,494100000,2018-11-16,200000000,159555901,652220086,452220086,226.110043
1162,Ant-Man and the Wasp,406000000,2018-07-06,130000000,216648740,623144660,493144660,379.3420461538461
1163,Ready Player One,445200000,2018-03-29,150000000,137690172,579290136,429290136,286.193424
1164,The Meg,384800000,2018-08-10,178000000,145443742,529530715,351530715,197.48916573033708
1165,Hotel Transylvania 3: Summer Vacation,361100000,2018-07-13,65000000,167500092,527079962,462079962,710.8922492307693
1166,Bumblebee,340800000,2018-12-21,102000000,127195589,465195589,363195589,356.0741068627451
1167,Solo: A Star Wars Story,179200000,2018-05-25,275000000,213767512,393151347,118151347,42.96412618181818
1168,Fifty Shades Freed,271500000,2018-02-09,55000000,100407760,371350619,316350619,575.1829436363637
1169,Peter Rabbit,236000000,2018-02-09,50000000,115234093,347136477,297136477,594.272954
1170,Mary Poppins Returns,177600000,2018-12-19,130000000,171958438,341528518,211528518,162.71424461538462
1171,A Quiet Place,152900000,2018-04-06,17000000,188024361,334522294,317522294,1867.7782
1172,Green Book,234700000,2018-11-16,23000000,85080171,322034439,299034439,1300.1497347826087
1173,Skyscraper,236400000,2018-07-13,125000000,68420120,304115534,179115534,143.2924272
1174,Maze Runner: The Death Cure,230200000,2018-01-26,61000000,58032443,265878536,204878536,335.8664524590164
1175,Tomb Raider,216400000,2018-03-16,90000000,58250803,273477501,183477501,203.86389
1176,Crazy Rich Asians,64000000,2018-08-15,30000000,174532921,238099711,208099711,693.6657033333333
1177,Smallfoot,130900000,2018-09-28,80000000,83240103,213691277,133691277,167.11409625
1178,Creed II,98300000,2018-11-21,50000000,115715889,213591522,163591522,327.183044
1179,The Equalizer 2,88300000,2018-07-20,77000000,102084362,190453132,113453132,147.34172987012988
1180,The Nutcracker and the Four Realms,119100000,2018-11-02,132900000,54858851,170293899,37393899,28.1368690744921
1181,The Mule,68700000,2018-12-14,50000000,103804407,170857676,120857676,241.715352
1182,Insidious: The Last Key,100100000,2018-01-05,10000000,67745330,167885588,157885588,1578.85588
1183,Red Sparrow,104700000,2018-03-02,69000000,46874505,145951861,76951861,111.52443623188407
1184,The First Purge,67500000,2018-07-04,13000000,69488745,136617305,123617305,950.9023461538461
1185,A Wrinkle in Time,32200000,2018-03-09,103000000,100478608,133401882,30401882,29.516390291262134
1186,Instant Family,53200000,2018-11-16,48000000,67363237,119736188,71736188,149.45039166666666
1187,The Commuter,83600000,2018-01-12,40000000,36343858,101985431,61985431,154.9635775
1188,Game Night,48500000,2018-02-23,37000000,69179066,117378084,80378084,217.23806486486487
1189,First Man,60800000,2018-10-12,60000000,44936545,105203825,45203825,75.33970833333333
1190,Alpha,62300000,2018-08-17,51000000,35851379,99624873,48624873,95.34288823529413
1191,A Simple Favor,44100000,2018-09-14,20000000,53548586,97628717,77628717,388.143585
1192,The Favourite,61600000,2018-11-23,15000000,34366783,94113929,79113929,527.4261933333333
1193,Truth or Dare,53900000,2018-04-13,3500000,41411015,95127344,91627344,2617.9241142857145
1194,I Feel Pretty,45700000,2018-04-20,32000000,48795601,91553797,59553797,186.105615625
1195,Blockers,33700000,2018-04-06,21000000,60311495,94045328,73045328,347.8348952380952
1196,Goosebumps 2: Haunted Halloween,46600000,2018-10-12,35000000,46697321,93291478,58291478,166.54708
1197,BlacKkKlansman,44000000,2018-08-10,15000000,49275340,93017335,78017335,520.1155666666667
1198,Sherlock Gnomes,47100000,2018-03-23,59000000,43242871,87527651,28527651,48.35195084745762
1199,Mortal Engines,67700000,2018-12-14,100000000,15951040,85287417,-14712583,-14.712583000000002
1200,Den of Thieves,35600000,2018-01-19,30000000,44947622,80131391,50131391,167.10463666666666
1201,Hereditary,35300000,2018-06-08,10000000,44069456,70133905,60133905,601.33905
1202,Tag,23400000,2018-06-15,28000000,54730625,77026186,49026186,175.09352142857142
1203,Vice,28200000,2018-12-25,60000000,47836282,70883171,10883171,18.138618333333334
1204,Widows,33600000,2018-11-16,40000000,42402632,73866088,33866088,84.66521999999999
1205,Sicario: Day of the Soldado,25800000,2018-06-29,35000000,50065850,75885196,40885196,116.81484571428571
1206,Second Act,33000000,2018-12-21,15700000,39282227,63288854,47588854,303.11371974522297
1207,Book Club,0,2018-05-18,10000000,68566296,91113683,81113683,811.13683
1208,12 Strong,21600000,2018-01-19,35000000,45819713,71118378,36118378,103.19536571428571
1209,"Love, Simon",25500000,2018-03-16,10000000,40826341,65520633,55520633,555.20633
1210,Mile 22,30200000,2018-08-17,35000000,36108758,66295121,31295121,89.41463142857144
1211,Life of the Party,12800000,2018-05-11,30000000,53059911,65759911,35759911,119.19970333333335
1212,Adrift,28500000,2018-06-01,35000000,31445011,57897191,22897191,65.42054571428572
1213,The 15:17 to Paris,20800000,2018-02-09,30000000,36276286,56096200,26096200,86.98733333333334
1214,Early Man,46400000,2018-02-16,50000000,8267544,45285890,-4714110,-9.42822
1215,Peppermint,18400000,2018-09-07,25000000,35418723,51800758,26800758,107.20303200000001
1216,Teen Titans Go! To The Movies,22300000,2018-07-27,10000000,29790236,51620593,41620593,416.20593
1217,Slender Man,21200000,2018-08-10,10000000,30564825,51723644,41723644,417.23644
1218,Uncle Drew,4200000,2018-06-29,18000000,42469946,46527161,28527161,158.4842277777778
1219,Mary Queen of Scots,29900000,2018-12-07,25000000,16468499,46734733,21734733,86.93893200000001
1220,The Possession of Hannah Grace,28200000,2018-11-30,6000000,14836174,42785387,36785387,613.0897833333333
1221,The Darkest Minds,28400000,2018-08-03,34000000,12695691,38361428,4361428,12.827729411764707
1222,On the Basis of Sex,13600000,2018-12-25,20000000,24622687,38073377,18073377,90.366885
1223,The Hate U Give,5200000,2018-10-05,23000000,29719483,35067665,12067665,52.46810869565217
1224,White Boy Rick,1900000,2018-09-14,30000000,24004833,25947983,-4052017,-13.506723333333333
1225,Winchester,0,2018-02-02,3500000,25091816,44378040,40878040,1167.944
1226,"Paul, Apostle of Christ",5500000,2018-03-23,5000000,17547999,25529498,20529498,410.58995999999996
1227,Proud Mary,876000,2018-01-12,30000000,20868638,21709539,-8290461,-27.63487
1228,Superfly,236000,2018-06-13,16000000,20537137,20723581,4723581,29.522381250000002
1229,If Beale Street Could Talk,5700000,2018-12-14,12000000,14915773,19859167,7859167,65.49305833333334
1230,Hell Fest,7100000,2018-09-28,5500000,11107431,18119231,12619231,229.44056363636363
1231,Unfriended: Dark Web,6300000,2018-07-20,1000000,8866745,16434588,15434588,1543.4587999999999
1232,Upgrade,2400000,2018-06-01,3000000,11977130,16553285,13553285,451.7761666666667
1233,Unsane,6600000,2018-03-23,1500000,7690044,14244931,12744931,849.6620666666666
1234,The Sisters Brothers,10000000,2018-09-21,38000000,3143056,13143056,-24856944,-65.41301052631579
1235,Welcome to Marwen,2100000,2018-12-21,45000000,10763520,12874922,-32125078,-71.38906222222222
1236,Hotel Artemis,6000000,2018-06-08,15000000,6708137,12758799,-2241201,-14.94134
1237,Kin,4300000,2018-08-31,30000000,5718096,10096821,-19903179,-66.34393
1238,Can You Ever Forgive Me?,0,2018-10-19,10000000,8803865,11752387,1752387,17.52387
1239,Suspiria,5400000,2018-10-26,20000000,2483472,7034615,-12965385,-64.826925
1240,The Hurricane Heist,0,2018-03-09,40000000,6115824,30963684,-9036316,-22.59079
1241,Destroyer,4000000,2018-12-25,9000000,1533324,3681096,-5318904,-59.098933333333335
1242,Gotti,0,2018-06-15,10000000,4286367,6089100,-3910900,-39.109
1243,Ben is Back,0,2018-12-07,13000000,3703182,9633111,-3366889,-25.899146153846154
1244,Bilal: A New Breed of Hero,1700000,2018-02-02,30000000,490973,648599,-29351401,-97.83800333333333
1245,Mandy,0,2018-09-14,6000000,1214525,1427656,-4572344,-76.20573333333334
1246,Lean on Pete,0,2018-04-06,8000000,1163056,2455027,-5544973,-69.3121625
